루나, 서울패션위크 패션쇼 모델로…런웨이 걷는다	일간스포츠
단풍 속으로 시속 85km 하강…서울랜드 루나파크 ‘달빛기행’	중앙일보
루나, 이런 모습 처음이야..새하얀 원피스 입고 청순청순	헤럴드POP
애경산업, 루나 슬림 브로우 메이커	아시아경제
루나솔라 지안, '가시리잇고' 주연 캐스팅…데뷔 2달만에 연기 도전	한국경제
루나솔라 지안, 데뷔 2달 만에 디지털 드라마 ‘가시리잇고’ 주연 발탁	한국경제TV
루나, 아름다움 돋보이는 자태…예쁨이 철철	헤럴드POP
루나·AGE 20's, 동남아 최대플랫폼 '쇼피' 진출	머니투데이
[콘솔] 스퀘어에닉스, 버전 업 된 '니어 레플리칸트' 루나 티어 에디션 공개	인벤
[신상품] 애경산업 '루나 슬림 브로우 메이커'	서울파이낸스
루나, 아련한 눈빛에 숨멎..매혹적인 자태로 리즈 갱신	헤럴드POP
[포토] 현진 '루나의 미소'	일간스포츠
여의도 직주근접 효과 기대되는 루나플라체ㆍㆍ 신안산선 개통까지	서울경제TV
'슈돌' 이태규, 루이∙루나 남매와 윌벤져스 집 방문	광주매일신문
루나, 거대한 명품백 매고 자연스러운 포즈.."콘서트 준비 중"	헤럴드POP
'슈돌' 이태규, 인형 같은 자녀들 공개..루이·루나 남매와 윌벤져스 집 방문	헤럴드POP
서울랜드에서 만나는 가을 …이색 단풍놀이 코스	뉴스렙
애경, 동남아 최대 플랫폼 '쇼피(Shopee)' 진출…"AGE 20's·루나 등 입점"	스포츠서울
루나솔라 지안, 데뷔 두달만 드라마 주연 발탁 '찬희·이승협과 호흡'	스포츠투데이
루나, 가슴 깊게 파인 아찔한 의상..몰라봤던 섹시 매력	헤럴드POP
'슈돌' 윌벤져스네 놀러 온 깜찍한 남매는 누구?	뉴시스
'에프엑스' 루나, '소속사 이적' 정수정 응원	뉴시스
[뷰티오늘] 한국콜마, 미혼한부모 가정 위한 물품 지원…이니스프리 모음재단...	시사오늘
'슈돌' 이태규子 루나, 벤틀리에 헬멧 뽀뽀 "벤 멋있어"[★밤TView]	스타뉴스
에프엑스 루나, 명품 쇼퍼백 들고 재벌 미소..연애 하나? [★SHOT!]	OSEN
"컬러 하나로 가을 분위기 내고 싶다면?"	세계일보
[오늘의 유통 단신] 삼성물산 구호, '팩' 협업 전시 개최 外	아이뉴스24
[오늘의 희소食] 탐앤탐스, 할로윈 음료 출시·이벤트 진행 外	인더뉴스
토종 와인이 주는 묘한 떨림.. 포르투갈 보석 함께 찾아보실래요?	파이낸셜뉴스
노키아, 달 최초 통신사업자 되나…NASA 4G 통신망 파트너로	동아사이언스
루나, 이렇게 섹시했나…반전 몸매에 깜짝	마이데일리
루나, 이렇게 글래머 였나..극강의 섹시한 매력	헤럴드POP
루나, 몸보다 큰 가방 들고 출장 중..미모에 물올랐네	헤럴드POP
‘에프엑스’ 루나…보름 닮은 풍성함, 가을 닮은 ‘페이소스’ [화보]	스포츠경향
[프린세스커넥트] 도발 탱커 편성, 힐러 4열 배치 자제! 루나의 탑 '킹 오르카...	인벤
루나, 섹시美 넘치는 자태에 숨멎…숨길 수 없는 볼륨감	헤럴드POP
"루나 예뻐요"…'슈퍼맨이 돌아왔다' 벤틀리, 이태규 딸에게 관심→헬멜 뽀뽀...	톱스타뉴스
신독산역 오피스텔 '루나플라체', 신안산선 개발 이슈 기대	메트로신문
[Product Review] 오픈소프트랩 '루나옵스'	데이터넷
[프린세스커넥트] 할쿄카, 루나, 성리스까지! 4분기에 등장할 캐릭터들은?	인벤
아마존, '루나'로 클라우드 게임 경쟁에 뛰어들어	IT조선
에프엑스 루나, 크리스탈 새 소속사 계약에 "축하하고 사랑해" 응원 [★해시태...	엑스포츠뉴스
위키미키 루나-엘리 ‘사녹 마치고 퇴근해요~’[포토엔HD]	뉴스엔
트럼프 최측근 수행원 코로나 감염 백악관 '초비상'	강원일보언론사 선정
애경 '루나', 올 가을 메이크업 트렌드 공개	주간한국
루나솔라 지안, 하트	서울경제
루나솔라, 데뷔 한 달 만에 '유희열의 스케치북' 출연…"큰 영광"	한국경제
‘배트맨’ 마스크 쓴 것처럼 태어난 루나 엄마 “혐오요 처음이 힘겹지”	서울신문
`그날들` 유준상·정성화·온주완·양요섭·루나·방민아 캐스팅…11월 개막	매일경제
"놀이기구 타며, 단풍 볼까?" 서울랜드 가을 전망 명소 추천	뉴스1
루나솔라 유우리, 하트	서울경제
‘시노니스’, 카나·루나 코스프레 화보 공개…모녀 케미 폭발	엑스포츠뉴스
인사하는 루나솔라 이서	서울경제
애경 루나 '데일리 크러쉬 아이 섀도우 팔레트' 선봬	파이낸셜뉴스
T3 '루나 모바일' 월드보스 추가	더게임스데일리
서울랜드, 취향따라 골라 즐기는 이색 단풍코스	쿠키뉴스
한글날 연휴 가볼만한 곳? 서울랜드, 가을 나들이 코스 제안	에듀동아
루나, 가슴골 드러낸 '아찔' 셀카…'미모+몸매 다 가졌네'	스포츠한국
행복을 찾아서	경북매일신문
루나솔라 태령, 심쿵 하트	서울경제
‘슈돌’ 프랑스인과 결혼한 이태규, 인형같은 아들 딸 공개 “윌벤져스 친구...	뉴스엔
T3 '루나 모바일' 출시…"경쟁 아닌 협력 추구" 	더게임스데일리
루나, 에프엑스 완전체 그리움..故 설리 태그 뭉클	헤럴드POP
루나 새 모델로 ‘서예지’ 발탁	일간스포츠
애경 루나, 뉴트로 감성으로 MZ세대 겨냥한‘HAPPY SONG 에디션' 출시	주간한국
애경, 루나 새 모델로 ‘서예지’ 발탁	파이낸셜뉴스
서울랜드, 취향따라 골라 즐기는 이색 단풍놀이 추천 코스 제안	더퍼스트
"여자친구 생기나"…새 친구 루나 만난 '슈퍼맨이 돌아왔다' 벤틀리	톱스타뉴스
루나솔라 이서 "가족과 TV에 나온 루나솔라 보고싶어요" [한복인터뷰]	이데일리
T3 '루나 모바일' 사전예약 실시	더게임스데일리
루나솔라 지안 "할머니댁 가면 문앞에서 춤추며 들어가고파" [한복인터뷰]	이데일리
업무·주거·문화 3대 인프라 모두 갖춘 오피스텔 루나플라체 인기	헤럴드경제
루나, 수영복으로 뽐낸 애플힙+개미허리	매일경제
루나, 오늘(31일) ‘우아한 친구들’ OST 발표	스포츠동아
[종합]'루나솔라' 상큼한 첫 V라이브 '노는 게 제일 좋아'(V앱)	헤럴드POP
루나 출시…100여개 게임 지원, MS 등에 도전장	중소기업뉴스
가수 루나, 13일 웹드라마 ‘반예인’ OST ‘꽃날’ 발표	문화일보
신예 루나솔라, 9월 2일 데뷔 확정 [공식]	이데일리
루나 웨들러-조이 파스텔, 스위스 미모의 여배우들(취리히영화제)[포토엔HD]	뉴스엔
코로나에 탄력받은 게임시장… IT 공룡들 '진격' 시작됐다	조선비즈언론사 선정
아마존, 클라우드 게임 서비스 '루나' 공개	아이뉴스24
[Daily New패션·뷰티] 루나, 아모레퍼시픽그룹, 신원 外	뉴데일리
루나 픽서 파우더 팩트 출시	일간스포츠
'10일 컴백' 핫펠트, 신곡 '라 루나' 프리뷰 공개	한국경제
루나솔라 '만찢녀' 비주얼	뉴스1
루나솔라 이서 '하트 요정'	뉴스1
루나솔라 태령 '애교 눈웃음'	뉴스1
[e면엔]클라우드 게임, 대체 뭐길래…'달려라 코바' 기억하시나요	노컷뉴스언론사 선정
T3, '루나 모바일' 9월 17일 정식 출시	아이뉴스24
게임 올라탄 아마존·MS·구글…구름 속 전쟁	머니투데이
"관능적 라틴사운드" 핫펠트, '라 루나' 오늘(10일) 발매	일간스포츠
[리뷰] 경쟁보다는 협력. 힐링 강조한 루나 모바일	게임동아
루나, 곧 베일 듯한 날렵한 턱선..건강美에 남심 '저격'	헤럴드POP
[주간 빅데이터 게임순위] 9월 2주차, 분위기 갈린 모바일, 온라인게임 TOP 1...	게임메카
'데뷔' 루나솔라, '노는 게 제일 좋아' 단체 티저 공개…펑키+시크	뉴스1
핫펠트, 관능적 라틴 ‘라 루나’ MV 티저 공개	스포츠동아
‘사랑의 콜센타’ 루나, ‘댄싱 퀸’부터 ‘너를 위해’까지…소름 가창력으...	한국경제TV
'데뷔' 루나솔라, '노는 게 제일 좋아' 티저 공개…시크함 가득	뉴스1
[TV북마크] ‘사랑의 콜센타’ 임영웅→김희재vs김준수→루나, 흥 터졌다 (종...	스포츠동아
리뷰 | 스튜디오 원 5 프로페셔널, 로직 X DAW의 손색 없는 호적수	ITWorld
애경 '루나', 올 가을 메이크업 트렌드 공개	주간한국
루나솔라 지안, 하트	서울경제
루나솔라, 데뷔 한 달 만에 '유희열의 스케치북' 출연…"큰 영광"	한국경제
‘배트맨’ 마스크 쓴 것처럼 태어난 루나 엄마 “혐오요 처음이 힘겹지”	서울신문
`그날들` 유준상·정성화·온주완·양요섭·루나·방민아 캐스팅…11월 개막	매일경제
"놀이기구 타며, 단풍 볼까?" 서울랜드 가을 전망 명소 추천	뉴스1
루나솔라 유우리, 하트	서울경제
트럼프 최측근 수행원도 감염…백악관 코로나19 '줄감염'	머니투데이언론사 선정
‘시노니스’, 카나·루나 코스프레 화보 공개…모녀 케미 폭발	엑스포츠뉴스
아마존, 클라우드 게임 플랫폼 '루나' 선보여	아시아경제
루나솔라 지안, 상큼한 포즈	서울경제
트럼프 최측근 수행원도 감염…백악관 코로나19 '줄감염'	머니투데이언론사 선정
‘시노니스’, 카나·루나 코스프레 화보 공개…모녀 케미 폭발	엑스포츠뉴스
아마존, 클라우드 게임 플랫폼 '루나' 선보여	아시아경제
인사하는 루나솔라 이서	서울경제
'그날들' 유준상·정성화·양요섭·루나·방민아·SF9인성 캐스팅 [공식입장]	엑스포츠뉴스
애경 루나 '데일리 크러쉬 아이 섀도우 팔레트' 선봬	파이낸셜뉴스
손인사하는 루나솔라 유우리	서울경제
T3 '루나 모바일' 월드보스 추가	더게임스데일리
서울랜드, 취향따라 골라 즐기는 이색 단풍코스	쿠키뉴스
아마존 클라우드 게임 진출, 월정액 서비스 '루나' 발표	디스이즈게임
루나솔라 지안, 오늘 아저씨 팬 추가!	서울경제
손인사하는 루나솔라 유우리	서울경제
루나솔라 이서, 상큼한 볼하트	서울경제
T3 '루나 모바일' 월드보스 추가	더게임스데일리
서울랜드, 취향따라 골라 즐기는 이색 단풍코스	쿠키뉴스
한글날 연휴 가볼만한 곳? 서울랜드, 가을 나들이 코스 제안	에듀동아
백악관에 퍼지는 코로나…트럼프 최측근 보좌관도 확진	부산일보언론사 선정
루나, 가슴골 드러낸 '아찔' 셀카…'미모+몸매 다 가졌네'	스포츠한국
행복을 찾아서	경북매일신문
아마존, 스태디아 대항마 '루나' 공개... 월정액에 트위치 연동 예고	인벤
행복을 찾아서	경북매일신문
루나솔라 태령, 심쿵 하트	서울경제
'슈돌' 윌리엄vs벤틀리, 불꽃 튀는 방구석하키 대결 [T-데이]	티브이데일리
‘슈돌’ 프랑스인과 결혼한 이태규, 인형같은 아들 딸 공개 “윌벤져스 친구...	뉴스엔
루나 데일리 크러쉬 아이 섀도우 팔레트	스타뉴스
T3 '루나 모바일' 출시…"경쟁 아닌 협력 추구" 	더게임스데일리
트럼프 최측근 수행원도 감염…백악관 내 코로나19 확산	연합뉴스
루나, 에프엑스 완전체 그리움..故 설리 태그 뭉클	헤럴드POP
루나 새 모델로 ‘서예지’ 발탁	일간스포츠
루나솔라 태령, 우아한 청순미	서울경제
트럼프 대통령 수행원 닉 루나 보좌관, 코로나19 확진	일요신문
루나, 에프엑스 완전체 그리움..故 설리 태그 뭉클	헤럴드POP
루나 새 모델로 ‘서예지’ 발탁	일간스포츠
루나, 로지·코랄의 유혹…메이크업 화보 공개	아시아경제
애경 루나, 뉴트로 감성으로 MZ세대 겨냥한‘HAPPY SONG 에디션' 출시	주간한국
애경, 루나 새 모델로 ‘서예지’ 발탁	파이낸셜뉴스
서울랜드, 취향따라 골라 즐기는 이색 단풍놀이 추천 코스 제안	더퍼스트
애경산업 루나 데일리 크러쉬 아이 섀도우 팔레트 출시	EBN
"여자친구 생기나"…새 친구 루나 만난 '슈퍼맨이 돌아왔다' 벤틀리	톱스타뉴스
애경산업 루나 데일리 크러쉬 아이 섀도우 팔레트 출시	EBN
"여자친구 생기나"…새 친구 루나 만난 '슈퍼맨이 돌아왔다' 벤틀리	톱스타뉴스
루나솔라 이서 "가족과 TV에 나온 루나솔라 보고싶어요" [한복인터뷰]	이데일리
T3 '루나 모바일' 사전예약 실시	더게임스데일리
트럼프 최측근 수행원도…백악관 내 코로나19 확산	SBS
"뉴트로 MZ 취향저격"…애경, '루나X위글위글 해피송 에디션' 선봬	뉴스1
애경 루나, 새 모델로 '사이코지만 괜찮아' 서예지 발탁	뉴스1
루나솔라 지안 "할머니댁 가면 문앞에서 춤추며 들어가고파" [한복인터뷰]	이데일리
업무·주거·문화 3대 인프라 모두 갖춘 오피스텔 루나플라체 인기	헤럴드경제
루나, 서예지 가을 메이크업 화보 공개	한국정책신문
트럼프 최측근도 줄줄이 감염...백악관·대선캠프 '비상'	YTN
루나솔라 지안 "할머니댁 가면 문앞에서 춤추며 들어가고파" [한복인터뷰]	이데일리
루나 데일리 크러쉬 아이 섀도우 팔레트 출시	이코노뉴스
업무·주거·문화 3대 인프라 모두 갖춘 오피스텔 루나플라체 인기	헤럴드경제
애경산업 루나, 새 모델로 '서예지' 발탁	이뉴스투데이
루나, 서예지 가을 메이크업 화보 공개	한국정책신문
루나, 수영복으로 뽐낸 애플힙+개미허리	매일경제
루나, 위글위글과 콜라보…"뉴트로 감성 담았다"	아시아경제
T3엔터테인먼트, 루나 모바일 정식 출시	ZDNet Korea
루나, 오늘(31일) ‘우아한 친구들’ OST 발표	스포츠동아
루나, 데일리 크러쉬 아이 섀도우 팔레트 선봬	한국정책신문
T3엔터테인먼트, 루나 모바일 정식 출시	ZDNet Korea
루나, 오늘(31일) ‘우아한 친구들’ OST 발표	스포츠동아
[종합]'루나솔라' 상큼한 첫 V라이브 '노는 게 제일 좋아'(V앱)	헤럴드POP
f(x) 루나, 크리스탈 새 소속사 이적에 "축하하고 사랑해"	아시아투데이
루나X위글위글 “뉴트로 감성 패키지 MZ세대 잡는다”	보건뉴스
루나 출시…100여개 게임 지원, MS 등에 도전장	중소기업뉴스
가수 루나, 13일 웹드라마 ‘반예인’ OST ‘꽃날’ 발표	문화일보
신예 루나솔라, 9월 2일 데뷔 확정 [공식]	이데일리
애경산업 '루나' 모델 서예지가 제안하는 올 가을 트렌드 '로지&코랄 메이크업...	이뉴스투데이
애경산업, 루나X위글위글 ‘HAPPY SONG 에디션’ 출시	로이슈
신예 루나솔라, 9월 2일 데뷔 확정 [공식]	이데일리
루나, '우아한 친구들' OST 가창 참여	이데일리
애경산업 '루나' 모델 서예지가 제안하는 올 가을 트렌드 '로지&코랄 메이크업...	이뉴스투데이
애경산업 루나 새 모델로 ‘서예지’ 발탁	로이슈
아마존도 클라우드 게이밍 시장 참전, 월 5.99 달러 서비스 '루나' 공개	게임포커스
루나 웨들러-조이 파스텔, 스위스 미모의 여배우들(취리히영화제)[포토엔HD]	뉴스엔
코로나에 탄력받은 게임시장… IT 공룡들 '진격' 시작됐다	조선비즈언론사 선정
아마존, 클라우드 게임 서비스 '루나' 공개	아이뉴스24
[Daily New패션·뷰티] 루나, 아모레퍼시픽그룹, 신원 外	뉴데일리
서예지, 고혹미 물씬 가을 여신…애경 '루나' 화보	뉴시스
[Daily New패션·뷰티] 루나, 아모레퍼시픽그룹, 신원 外	뉴데일리
루나, 탄력 넘치는 수영복 자태 인증..탄탄 애플힙	헤럴드POP
루나 픽서 파우더 팩트 출시	일간스포츠
'10일 컴백' 핫펠트, 신곡 '라 루나' 프리뷰 공개	한국경제
루나솔라 '만찢녀' 비주얼	뉴스1
루나솔라 이서 '하트 요정'	뉴스1
시노니스, '카미시로 카나'와 '루나' 코스프레 공개	포모스
루나솔라 태령 '애교 눈웃음'	뉴스1
루나, 드라마 ‘우아한 친구들’ OST ‘Cheers’ 31일 발매	한국경제TV
루나솔라 이서 '얼굴 하트 뿅'	뉴스1
루나솔라 지안, 하트	서울경제
루나, 드라마 ‘우아한 친구들’ OST ‘Cheers’ 31일 발매	한국경제TV
루나솔라, 25일 ‘유희열의 스케치북’ 출연	스포츠경향
[e면엔]클라우드 게임, 대체 뭐길래…'달려라 코바' 기억하시나요	노컷뉴스언론사 선정
T3, '루나 모바일' 9월 17일 정식 출시	아이뉴스24
조이 파스텔-닐람 파루크-루나 웨들러, 취리히 영화제에 뜬 미녀 3인방[포토엔...	뉴스엔
루나 새 모델로 '서예지' 발탁	이코노뉴스
유주게임즈코리아, 시노니스 인기 캐릭터 ‘카미시로 카나’, ‘루나’ 코스프...	게임동아
애경산업, '루나 라이브 클래스' 진행	부산일보
게임 올라탄 아마존·MS·구글…구름 속 전쟁	머니투데이
"관능적 라틴사운드" 핫펠트, '라 루나' 오늘(10일) 발매	일간스포츠
[리뷰] 경쟁보다는 협력. 힐링 강조한 루나 모바일	게임동아
애경산업, 언택트 트렌드에 맞춰 ‘루나 라이브 클래스’ 진행	파이낸셜뉴스
'슈퍼맨' 이태규 프랑스인 아내와 결혼해 낳은 인형 남매 공개 [TV캡처]	스포츠투데이
루나, 곧 베일 듯한 날렵한 턱선..건강美에 남심 '저격'	헤럴드POP
루나솔라 태령 '말랑말랑 하트'	뉴스1
신인 걸그룹 '루나솔라' 입니다	뉴스1
루나솔라 이서 '눈에 확 띄잖아'	뉴스1
T3엔터테인먼트, '루나 모바일' 17일 출시	전자신문
루나솔라 지안 '인형의 인사'	뉴스1
T3엔터테인먼트, '루나 모바일' 17일 출시	전자신문
루나솔라 이서, 다정한 하트	서울경제
핫펠트, 오늘(10일) ‘라 루나’ 발매…유혹의 라틴 예고	스포츠동아
손인사하는 루나솔라 태령	서울경제
T3, 루나 모바일 '월드보스' 25일 업데이트	이뉴스투데이
[주간 빅데이터 게임순위] 9월 2주차, 분위기 갈린 모바일, 온라인게임 TOP 1...	게임메카
'데뷔' 루나솔라, '노는 게 제일 좋아' 단체 티저 공개…펑키+시크	뉴스1
T3, 힐링 MMOPRG ‘루나 모바일’ 정식 출시	이데일리
애경산업, 루나 '서예지'와 함께한 메이크업 화보 공개	이지경제
핫펠트, 관능적 라틴 ‘라 루나’ MV 티저 공개	스포츠동아
루나 모바일, 정식 출시	게임샷
‘사랑의 콜센타’ 루나, ‘댄싱 퀸’부터 ‘너를 위해’까지…소름 가창력으...	한국경제TV
애경산업, ‘루나 라이브 클래스’ 진행	로이슈
'데뷔' 루나솔라, '노는 게 제일 좋아' 티저 공개…시크함 가득	뉴스1
애경산업 루나, "새 모델로 '서예지' 발탁"	파이낸셜투데이
루나솔라, 도도하면서도 펑키… 단체 콘셉트 포토 '시선강탈'	이데일리
[TV북마크] ‘사랑의 콜센타’ 임영웅→김희재vs김준수→루나, 흥 터졌다 (종...	스포츠동아
루나 매력 보컬, `우아한 친구들` OST 참여	디지털타임스
루나솔라, 데뷔 1달 만에 '유스케' 출연 "소원하던 무대"	더팩트
리뷰 | 스튜디오 원 5 프로페셔널, 로직 X DAW의 손색 없는 호적수	ITWorld
'컴백 D-1' 핫펠트, 새 싱글 '라 루나' MV 티저 공개	한국경제
신인 가수 '루나솔라' 사랑해 주세요	뉴스1
루나 모바일, 25일 월드보스 업데이트	포모스
루나솔라 유우리, 여성미 뿜뿜	서울경제
루나, 웹드라마 '반예인' OST Part6 '꽃날' 발매	bnt뉴스
[공식]루나, JTBC '우아한 친구들' OST 참여…오늘(31일) 'Cheers' 발매	스포츠조선
T3, '루나 모바일' 31일부터 사전예약	아이뉴스24
에프엑스 루나, 크리스탈과 다정 투샷 “수정이랑 데이트 했지롱”[SNS★컷]	뉴스엔
신인그룹 루나솔라, 9월 2일 데뷔 확정…두 번째 개인 컨셉 포토 공개	한국경제TV
신인그룹 루나솔라, 9월 2일 데뷔 확정…두 번째 개인 컨셉 포토 공개	한국경제TV
"가을 분위기 물씬"…루나, '멀티 아이 섀도우 팔레트' 선봬	뉴스1
신예 루나솔라, 데뷔 한 달 만에 '유희열의 스케치북' 입성…25일 방송	뉴스1
루나솔라 지안·유우리·이서·태령, 4인4색 콘셉트 포토	MBC연예
루나X크리스탈, 다정한 데이트 인증샷..에프엑스 우정ing [★SHOT!]	OSEN
[신상NEWS] 애경산업, ‘루나X위글위글 해피송 에디션’ 출시 外	뉴스투데이
루나솔라, 단체 콘셉트 포토 공개…데뷔곡 '노는 게 제일 좋아' 기대감 상승	한국경제
T3, 신작 ‘루나 모바일’ 월드보스 업데이트 예고	매일경제
'사이코지만 괜찮아' 서예지, 루나 화장품 새 모델로	한국경제
애경산업 루나(LUNA) 새 모델로 '서예지' 발탁	비지니스코리아
애경산업 루나(LUNA) 새 모델로 '서예지' 발탁	비지니스코리아
핫펠트, 관능적 유혹…신곡 '라 루나' 뮤비 티저 공개	뉴시스
루나 모바일 '월드보스' 25일 선보인다	게임샷
‘우아한 친구들’ OST ‘Cheers’ 가수 루나 부른다	스포츠경향
루나솔라, '유희열의 스케치북' 뜬다…'노는 게 제일 좋아' 열창	MBC연예
루나솔라 유우리 '신비로운 보라빛 헤어'	뉴스1
'데뷔' 루나솔라, 오늘(2일) '노는 게 제일 좋아' 공개	한국경제
에프엑스 출신 루나, 잠옷 입고 상큼하게..우월한 민낯 미모	헤럴드POP
T3, 17일 '루나 모바일' 출격	프라임경제
T3, 힐링 MMOPRG '루나 모바일' 정식 출시	게임조선
T3, 17일 '루나 모바일' 출격	프라임경제
T3, 힐링 MMOPRG '루나 모바일' 정식 출시	게임조선
루나솔라, 데뷔곡 '노는 게 제일 좋아' 콘셉트 포토 공개…개성 '톡톡' 매력	한국경제
T3 '루나 모바일' 8월 중 테스트 예고	더게임스데일리
루나솔라, 두번째 콘셉트 포토 공개…9월 2일 데뷔 확정	스포츠서울
[유희열의 스케치북] 4인조 걸 그룹 루나솔라의 데뷔곡 ♬ 노는 게 제일 좋아	KBS 연예
4인조 신인 걸그룹 루나솔라, 단체 콘셉트 포토 첫 공개 ‘상반된 매력 눈길’	한국경제TV
김준수·차지연·홍지민·강홍석·루나·신인선 '사랑의 콜센타' 흥 폭발	뉴시스
아마존도 클라우드 게이밍 서비스 시장 합류, 아마존 '루나' 공식 발표	케이벤치
'슈퍼맨이 돌아왔다' 이태규-올리비아 부부, 남매 자녀와 윌벤져스 집 방문! ...	엔터미디어
'슈퍼맨이 돌아왔다' 이태규-올리비아 부부, 남매 자녀와 윌벤져스 집 방문! ...	엔터미디어
온라인 원작의 모바일 MMORPG, '루나 모바일'	게임샷
핫펠트, 아메바컬쳐 15주년 기념 신곡 발표…관능적 '라 루나'	뉴스1
루나, 가을 시즌 활용도 높은 '루나 데일리 크러쉬 아이 섀도우 팔레트' 출시	더퍼스트
T3 '루나 모바일' 정식 출시	EBN
루나솔라, 데뷔 전부터 광고업계 러브콜	MBC연예
[단독]'사랑의 콜센타' 루나 "감사하고 행복했다‥좋은 음악으로 찾아뵐 것"(...	헤럴드POP
루나솔라 (LUNARSOLAR), ‘깜찍한 한가위 인사’ [뉴스엔TV]	뉴스엔
루나솔라 유우리-지안, 출근길 하트	서울경제
루나, '반예인' OST '꽃날' 부른다…오늘(13일) 공개	마이데일리
루나솔라, 단체 콘셉트 포토 공개···유쾌한 분위기로 데뷔 기대감 ↑	서울경제
루나, 이찬원과 탄탄한 고음 대결로 빛난 막내파워	뉴스컬처
T3 '루나 모바일' 9월 17일 출시	EBN
'사랑의 콜센타' 김준수부터 루나, 신인선까지…뮤지컬 배우 특집	한국경제
핫펠트, 히트곡메이커 라이언전과 손잡았다…10일 신곡 ‘라 루나’ 발매	문화일보
루나, 데일리 크러쉬 아이 섀도우 팔레트 출시	아시아경제
핫펠트, ‘라 루나’로 10일 컴백 [공식]	스포츠경향
T3, 힐링 MMOPRG '루나 모바일' 정식 출시	이뉴스투데이
핫펠트 `라 루나` 티저…매혹적인 눈빛	매일경제
루나, 뉴트로 감성 담은 '루나X위글위글 HAPPY SONG 에디션' 출시	더퍼스트
루나, 뉴트로 감성 담은 '루나X위글위글 HAPPY SONG 에디션' 출시	더퍼스트
T3, 루나 모바일 '월드보스' 25일 첫 업데이트 실시	게임조선
핫펠트, 이번엔 라틴이다! 파격 변신 속 신곡 '라 루나' 기대 UP	스포츠조선
신인 걸그룹 레드스퀘어가 함께 한 루나 모바일 오프닝송 화제	게임동아
애경산업, '루나 라이브 클래스' 진행	이코노뉴스
시노니스, 캐릭터 ‘카미시로 카나’ / ‘루나’ 코스프레 화보 공개	게임샷
힐링 MMOPRG '루나 모바일', 오늘(17일) 정식 출시	엑스포츠뉴스
핫펠트, '라 루나' 오늘(10일) 공개···라이언전과 손 잡았다	서울경제
루나 새 모델로 배우 서예지 발탁	매일경제TV
루나솔라, 데뷔 한 달 만 '유희열의 스케치북' 입성	스타뉴스
서울랜드, 언택트 축제 ‘서울랜드 2020 루나 마스크 파티’ 개최	에듀동아
핫펠트, 히트곡메이커 라이언전과 손잡아...신곡 '라 루나' 발매	SBS funE
루나 웨들러, 롱다리 강조한 포즈(취리히영화제)[포토엔HD]	뉴스엔
T3, 힐링 게임 ‘루나 모바일’ 31일부터 사전예약	파이낸셜뉴스
[TEN 포토] 루나솔라 '즐거운 출근길'	텐아시아
루나솔라 태령 "벌써 데뷔 한 달… 매일매일이 행복해요" [한복인터뷰]	이데일리
루나X크리스탈, 훈훈한 우정 #에프엑스_멤버전체태그 [리포트:컷]	TV리포트
'사이코지만 괜찮아' 서예지, 애경 '루나' 새 모델 된다	베이비타임즈
[포토]루나솔라, 즐거운 한가위되세요!	이데일리
[포토]루나솔라가 왔어요~	헤럴드POP
[포토]루나솔라, 즐거운 한가위되세요!	이데일리
[포토]루나솔라가 왔어요~	헤럴드POP
핫펠트, 히트곡메이커 라이언전과 손잡았다…10일 신곡 '라 루나' 발매	한국경제TV
핫펠트, 신곡 ‘라 루나’ 프리뷰 공개…이번엔 라틴이다	MK스포츠
루나, 드라마 '우아한 친구들' OST 참여…오늘(31일) 발매	엑스포츠뉴스
신예 루나솔라, 데뷔 한 달 만에 꿈의 무대 ‘유스케’ 입성	엑스포츠뉴스
T3엔터테인먼트 신작 '루나 모바일' 출시 임박	더팩트
서울랜드, 언택트 축제 ‘루나 마스크 파티’	파이낸셜뉴스
신예 루나솔라, 정식 데뷔 전 광고계 눈도장 '쾅'	이데일리
애경산업, '루나 라이브 클래스' 진행	뉴스토마토
신예 루나솔라, 정식 데뷔 전 광고계 눈도장 '쾅'	이데일리
애경산업, '루나 라이브 클래스' 진행	뉴스토마토
‘아돌라’ 루나솔라 ‘노는 게 제일 좋아’로 K팝 대표 걸그룹 될 떡잎(종합...	뉴스엔
신인그룹 루나솔라, 데뷔곡 ‘노는 게 제일 좋아(OH YA YA YA)’ 개인 컨셉 포...	한국경제TV
‘10일 컴백’ 핫펠트 신곡 ‘라 루나’ 프리뷰 공개, 강렬 라틴 사운드	스포츠동아
루나, 캉캉 원피스 입고 생기발랄 점프 "그리운 '맘마미아' 소피야"	헤럴드POP
[N인터뷰] 루나솔라 "오랜 노력 끝 데뷔…기다려준 팬 응원에 눈물·감동"	뉴스1
에뛰드·3CE·루나, 매력적인 가을 컬러 담은 뷰티템 출시	디지틀조선일보
T3, 신작 모바일 MMORPG ‘루나 모바일’ 17일 출시	매일경제
미국 심장부에 퍼지는 코로나…트럼프 최측근 수행원도 확진	디지털타임스
T3, 신작 모바일 MMORPG ‘루나 모바일’ 17일 출시	매일경제
미국 심장부에 퍼지는 코로나…트럼프 최측근 수행원도 확진	디지털타임스
시노니스, 캐릭터 카미시로 카나와 루나 코스프레 화보 공개	베타뉴스
T3, 동화풍 감성 힐링 MMORPG ‘루나 모바일’ 출시	매일경제
루나, 언제 이렇게 청순해졌어‥러블리 여신님	헤럴드POP
세븐나이츠 타임원더러, 11월 5일 출시 '넷마블 첫 콘솔 도전'	게임플
루나솔라, 내달 2일 '노는 게 제일 좋아'로 가요계 공식 데뷔	시사포커스
[포토]루나솔라 태령, 청순 여신	헤럴드POP
'루나 모바일', 25일 월드보스 업데이트…협동 플레이 극대화	엑스포츠뉴스
[포토]루나솔라 이서, 핑크빛 하트	헤럴드POP
[포토]루나솔라 지안, 청순 요정	헤럴드POP
루나솔라, 데뷔곡 '노는 게 제일 좋아' 콘셉트 포토 공개···독보적 개성 눈...	서울경제
애경산업 루나 '서예지' 메이크업 화보 공개	EBN
[N샷] 루나, 강렬한 레드 보디슈트…과감 섹시미	뉴스1
핫펠트, 25일 '뮤콘 2020' 출격→신곡 '라 루나' 무대 공개	일간스포츠
핫펠트의 관능적 유혹, 신곡 ‘라 루나’ 뮤직비디오 티저 공개	한국경제TV
루나솔라 태령-이서-지안-유우리, 인사드립니다	서울경제
레이먼킴♥︎김지우 딸, 셰프아빠 반찬에도 결국 엄마 미역국 "애간장 녹이더...	OSEN
한빛 모회사 T3, 동화풍 힐링 MMORPG 루나 모바일 출시	게임메카
핫펠트, 신곡 '라 루나'로 컴백	뉴스컬처
핫펠트, 신곡 '라 루나'로 컴백	뉴스컬처
루나솔라 유우리 "매일 꿈속서 사는 기분… 데뷔 실감 안나요" [한복인터뷰]	이데일리
루나솔라 이서·태령·지안·유우리, 오늘(2일) 공식 데뷔	MBC연예
T3, 루나 모바일 ‘월드보스’ 25일 선보인다	NSP통신
신인그룹 루나솔라, 9월 2일 데뷔확정..'청순+러블리'	enews24
루나, 드라마 '우아한 친구들' OST 'Cheers' 가창...오늘(31일) 발매	bnt뉴스
[TEN 포토] 루나솔라 지안 '반가움의 토끼눈'	텐아시아
[TEN 포토] 루나솔라 이서 '커피 들고 해맑은 인사'	텐아시아
[TEN 포토] 루나솔라 유우리 '신비로운 요정 비주얼'	텐아시아
[RE:TV] '더킹' 이민호, 또 다른 자신의 존재 알았다…루나 김고은에 당해	뉴스1
루나, '우아한 친구들' OST 참여...오늘(31일) 'Cheers' 발매	한국일보
[RE:TV] '더킹' 이민호, 또 다른 자신의 존재 알았다…루나 김고은에 당해	뉴스1
클라우드 강자들, 게임시장서 재대결	아이뉴스24언론사 선정
루나 모바일, 31일부터 사전예약	게임샷
F(x) 출신 가수 루나의 다이어트 비결…식후 꼭 챙겨 먹는 '칼로커트'	조세일보
[포토]루나솔라, 개성강한 4인조 걸그룹	헤럴드POP
[포토]루나솔라 이서, 깜찍이 볼하트	헤럴드POP
'8월 데뷔' 루나솔라, 데뷔곡 '노는 게 제일 좋아' 콘셉트 포토 공개	엑스포츠뉴스
루나 웨들러, 어마어마한 통굽 킬 힐 신고~(취리히영화제)[포토엔HD]	뉴스엔
루나솔라, 단체 콘셉트 포토 첫 공개! 시크+펑키	마켓뉴스
트럼프 최측근 수행원, 코로나19 확진…백악관 내 확산 ‘비상’	에너지경제
서울랜드, 한글날 연휴 맞이해 1석 3조 가을 나들이 제안	더퍼스트
[포토] 걸그룹 루나솔라, 한복입고 추석인사	이데일리
루나 모바일, 프리오픈테스트 신청자 20만명 돌파	게임동아
4인조 신인그룹 루나솔라, 2일 가요계 데뷔…'솔라 : 플레어'	이데일리
루나솔라 태령-이서-지안-유우리 '쇼 음악중심' 출동	서울경제
동화 같은 MMORPG, T3 신작 루나 모바일 9월 17일 출시	게임메카
루나, 검정 속옷에 '청순X섹시' 극과극 매력…"가장 좋아하는 룩"	스포츠조선
다양한 꾸미기와 협력의 재미. 루나 모바일, 원작 감성 그대로 살렸다	동아일보
루나솔라, 데뷔곡 '노는 게 제일 좋아' 4人 4色 콘셉트 포토	스타뉴스
루나솔라, 데뷔곡 '노는 게 제일 좋아' 4人 4色 콘셉트 포토	스타뉴스
'사랑의 콜센타' 뮤지컬 배우 특집, 김준수·차지연→루나·신인선 출연	이데일리
아마존 게임 시장 출사표...클라우드 게임 서비스 '루나' 출시	디지털투데이
T3, 모바일 신작 '루나 모바일' 국내 정식 서비스 나서	뉴데일리
에프엑스 루나, 강렬한 레드 보디슈트 "파격 카리스마"	스포츠조선
루나솔라, 노는 게 제일 좋은 걸그룹…오늘(2일) 데뷔	더팩트
루나솔라, 단체 콘셉트 포토 첫 공개…데뷔곡 '노는 게 제일 좋아' 기대 ↑	엑스포츠뉴스
T3 '루나 모바일' 25일 점검 통해 월드 보스 공개	게임포커스
루나솔라, ‘뮤직뱅크’서 강렬 눈도장… 단숨에 실검 1위 등극	이데일리
철부지 선생, 야크가 되다	오마이뉴스
핫펠트, 25일 '2020 서울국제뮤직페어' 출격…신곡 '라 루나' 무대 공개	스포츠동아
[SR유통] 애경산업, '루나' 새 모델로 '서예지' 발탁	SR타임스
루나솔라, 데뷔 자축 "행복과 사랑 드릴 것"	매일경제
T3 '루나 모바일' 매출순위 지속 상승 눈길	더게임스데일리
[포토]루나솔라 유우리, 만화찢고 나왔어요~	헤럴드POP
에프엑스 루나, 오리발 내밀고 코 찡긋 [SNS★컷]	뉴스엔
"에프엑스 완전체" 루나 故설리 향한 그리움	머니S
T3, 루나 모바일 25일 '월드보스' 선보인다	매일일보
T3, 힐링 MMOPRG 루나 모바일 정식 출시	NSP통신
"투명 코팅막으로 메이크업 고정"…루나, '픽서 파우더 팩트' 선봬	뉴스1
루나솔라, 데뷔와 동시에 관심 폭발···오늘(3일) '엠카' 첫 무대	일간스포츠
애경산업, 루나 픽서 파우더 팩트 출시	이코노믹리뷰
9월 중 정식 출시, T3 신작 루나 모바일 사전예약 시작	게임메카
신인그룹 루나솔라(LUNARSOLAR), 9월 2일 데뷔 확정	톱데일리
T3엔터 신작 MMOPRG '루나 모바일' 정식 출시	게임포커스
[포토]루나솔라 추석인사, 풍성한 한가위되세요!	이데일리
애경산업, 메이크업 브랜드 '루나' 새 모델에 배우 서예지 발탁	이지경제
과천 서울랜드, 언택트 축제 '2020 루나 마스크 파티' 선보인다	경인일보
T3, '루나 모바일' 17일 출시	한국정책신문
에프엑스 루나, 그렇게 바라보면 심쿵..청초美 폭발	헤럴드POP
T3, 신작 '루나 모바일' 17일 출시… 사전예약 30만명 돌파	뉴데일리
애경산업, 루나 픽서 파우더 팩트 출시	로이슈
아마존, 게임 스트리밍 앱 루나 출시	연합인포맥스
이찬원 "루나 '복면가왕' 가왕, 거기서나 알아주는 것"	충청일보
[이지 돋보기] 유통업계, 코로나19 악재 뚫자!…'뉴트로' 앞세워 중장년·MZ세...	이지경제
‘사랑의 콜센타’ 김준수x차지연x홍지민x강홍석x루나x신인선 출격	매일경제
유주게임즈코리아, ‘시노니스’ 캐릭터 ‘카미시로 카나’, ‘루나’ 코스프...	게임조선
루나솔라, 데뷔와 동시에 홈페이지 트래픽 초과…관심 폭발	뉴스1
T3, '루나 모바일' 31일부터 사전예약 실시	로이슈
"관능적, 춤사위"…핫펠트, '라 루나' 뮤비 티저	마이데일리
T3 '루나 모바일' CBT 종료..호평 속 기대감 증폭	파이낸셜뉴스언론사 선정
핫펠트, 오늘(10일) 신곡 '라 루나' 발매	톱데일리
루나솔라, 화사한 소녀들 [포토엔HD]	뉴스엔
T3엔터테인먼트, 신작 ‘루나 모바일’ 31일 사전예약	매일경제
애경 루나, 픽서 파우더 팩트 출시	스타뉴스
T3, 힐링 MMOPRG '루나 모바일' 정식 출시	매일일보
루나, '피부 바탕 올려주는' 부스터 출시	아시아경제
루나솔라, 오늘(2일) 데뷔 앨범 'SOLAR : flare' 발매···4인 4색 개성 눈길	서울경제
'사랑의 콜센타' 루나, 임재범의 '너를 위해' 열창...감성 가득한 매력 발산	톱데일리
업비트, 스테이킹 시장 진입 까닭은	팍스넷뉴스
'10일 컴백' 핫펠트, 신곡 '라 루나' 프리뷰 공개…강렬 라틴 사운드	스포츠서울
"홈페이지 서버 다운" 루나솔라, 데뷔 직후 뜨거운 관심	이데일리
핫펠트, 히트곡메이커 라이언전과 손잡았다…‘라 루나’ 발매 [MK★오늘의신...	MK스포츠
루나 모바일, 9월17일 출시…사전예약 30만명 돌파	게임샷
에프엑스 루나, 끈 티셔츠 입고 섹시美 폭발…매일이 리즈 갱신	헤럴드POP
루나, 웹드라마 '반예인' OST '꽃날' 참여…13일 발매	일간스포츠
루나 새 모델로 '서예지' 발탁	워크투데이
‘대세 신인’ 루나솔라, 오늘(25일) ‘유희열의 스케치북’ 출연 [공식입장]	엑스포츠뉴스
루나, 레드 보디슈트 입고 섹시 카리스마 뿜뿜	매일경제
루나X위글위글 ‘HAPPY SONG 에디션’ 출시	스타뉴스
루나, 레드 보디슈트 입고 섹시 카리스마 뿜뿜	매일경제
루나X위글위글 ‘HAPPY SONG 에디션’ 출시	스타뉴스
시노니스, '카미시로 카나'·'루나' 코스프레 화보 공개	청년일보
NHN벅스 레이블 제이플래닛 엔터테인먼트, 첫 걸그룹 루나솔라 론칭…8월 데뷔	텐아시아
T3, 루나 모바일 '포커스그룹테스트' 진행	아이뉴스24
루나 크리스탈 베이비 부스터 출시	스타뉴스
루나솔라 지안, 세상 우아하게~ [포토엔HD]	뉴스엔
[포토] 루나솔라, 상큼한 소녀들	일간스포츠
[포토]걸그룹 루나솔라, 추석 한복 인사는 상큼 발랄하게	이데일리
패션·뷰티업계, '가을 느낌 물씬' 컬러 아이템 인기	싱글리스트
[포토]루나솔라, '보름달 아래 행복한 시간 보내세요'	이데일리
패션·뷰티업계, '가을 느낌 물씬' 컬러 아이템 인기	싱글리스트
T3 신작 ‘루나 모바일’, 성장과 모험은 ‘기본’…즐길거리 ‘풍성’	매일경제
루나솔라 태령, 심쿵 하트 [포토엔HD]	뉴스엔
루나솔라 태령, 수수하게 [포토엔HD]	뉴스엔
핫펠트, 신곡 '라 루나' 10일 컴백…강렬 라틴 사운드 '파격 변신'	엑스포츠뉴스
루나솔라 이서, 청순깜찍 [포토엔HD]	뉴스엔
루나, 구릿빛 피부+섹시한 뒤태…"수영복 입고 당당한 포즈"	스포츠조선
루나, JTBC '우아한 친구들' OST 참여…신곡 'Cheers' 금일 공개	RPM9
핫펠트, 신곡 '라 루나' 뮤비 티저영상 공개…관능적 춤사위	헤럴드POP
T3, '루나 모바일' 28일 프리오픈테스트 시작	매일일보
루나솔라, 데뷔는 'SOLAR' 콘셉트	뉴스컬처
애경산업, 루나X위글위글 'HAPPY SONG 에디션' 출시	워크투데이
루나, 속옷 위에 빨간 재킷으로 완성한 룩…치명적 비주얼에 숨멎	헤럴드POP
T3 신작 ‘루나 모바일’ 오프닝 송 ‘투게더’ 화제	매일경제
루나, 숨길수 없는 글래머 몸매로 농장 인증샷 "오미자 2바구니"	enews24
[이종길의 영화읽기]함께 사는 삶, 부탄의 행복 교육법	아시아경제
애경산업, 루나 데일리 아이 섀도우 팔레트 출시	현대경제신문
T3엔터테인먼트, MMORPG '루나 모바일' 서비스 시작	서울파이낸스
루나, 빨간 수영복으로 치명적인 섹시美 과시[★SNS]	스포츠서울
루나, 빨간 수영복으로 치명적인 섹시美 과시[★SNS]	스포츠서울
신인 걸그룹 루나솔라, 2일 싱글 앨범 'SOLAR : flare'로 가요계 데뷔	스포츠서울
T3 신작 ‘루나 모바일’, 인기 몰이…매출 순위 지속 상승	매일경제
루나, 팔색조 매력 뽐내 [화보]	스포츠동아
루나, 셔츠 풀어헤치고 속옷만..남다른 섹시美	스타뉴스
동화풍 힐링 MMORPG '루나 모바일', 오늘(31일)부터 사전예약	엑스포츠뉴스
루나, '픽서 파우더 팩트' 출시	이코노뉴스
애경산업 루나 새 모델에 배우 서예지	MBN
신인 걸그룹 루나솔라, 데뷔부터 '핫'하다…홈페이지 서버 다운	텐아시아
루나솔라 "송편 빚으며 '오야야야'… '노는 게 제일 좋아'가 딱!" [한복인터뷰...	이데일리
루나, '우아한 친구들' OST 'Cheers' 오늘(31일) 발매.."인생을 즐기자"	OSEN
"가장 좋아하는 룩" 루나, 화끈하게 드러낸 란제리 화보	스포츠한국
[포토]걸그룹 루나솔라, '보름달 아래 행복한 시간 보내세요'	이데일리
루나, 손톱부터 메이크업까지 완벽한 가을무드..아름다운 눈빛 [★SHOT!]	OSEN
핫펠트, 아메바 15주년 프로젝트 새 주자...10일 '라 루나' 공개	한국일보
힐링 RPG '루나 모바일' 28일부터 테스트 개시	아이뉴스24
핫펠트, 신곡 '라 루나' 발매 기념 '블루룸라이브' 조회수 '100만뷰 돌파'	한국경제TV
루나솔라, 첫 싱글 앨범 [SOLAR : flare] 발매	스포츠한국
루나솔라 지안, 러블리한 천사하트 [포토엔HD]	뉴스엔
루나솔라 태령, 순백의 천사강림 [포토엔HD]	뉴스엔
'컴백' 핫펠트, 파격 변신 신곡 '라 루나' 프리뷰 공개..강렬 라틴 사운드	헤럴드POP
루나, 압도적 수영복 S라인..우아한 섹시미[화보]	헤럴드POP
핫펠트, 신곡 '라 루나' M/V 티저 공개	톱데일리
루나솔라, 데뷔곡 '노는 게 제일 좋아' 개인 컨셉 포토 공개	톱데일리
T3의 힐링 MMOPRG '루나 모바일' 정식 출시	인벤
‘믿고 듣는’ 루나, 웹드라마 ‘반예인’ OST '꽃날' 참여	한국경제TV
루나솔라, 데뷔와 동시에 관심 폭발…오늘(3일) ‘엠카’서 무대 공개	MK스포츠
끈적이는 여름도 거뜬…루나, 픽서 파우더팩트 출시	아시아경제
에프엑스 루나, 속옷 입고 인증샷 촬영..섹시 매력 한도초과	헤럴드POP
루나솔라(LUNARSOLAR), 신비+청초 'SOLAR : flare' 가요계 첫 데뷔	시사포커스
T3, 힐링 MMOPRG '루나 모바일' 정식 출시	프레스맨
루나솔라(LUNARSOLAR), 신비+청초 'SOLAR : flare' 가요계 첫 데뷔	시사포커스
루나X크리스탈, 친자매 같은 케미에 흐뭇.."뚜덩이 써치 대박나랏"	헤럴드POP
애경산업, 비대면 소통 '루나 라이브 클래스' 진행	컨슈머타임스
'루나 모바일', 오늘(31일)부터 사전예약…한정판 코스튬 지급	엑스포츠뉴스
[더쇼 라인업] 러블리즈·더보이즈·프로미스나인·크나큰·에버글로우·루나...	미디어펜
루나솔라 지안, 순백의 천사 [포토엔HD]	뉴스엔
‘달빛의 몽롱함’ 핫펠트, 라이언전과 손잡고 ‘라 루나’ 금일 발표	bnt뉴스
구글 화면 달린 AI스피커에서 ‘파이팅 루나’ 쓰세요	이데일리
루나 모바일, 8월 중 FGT 실시	게임샷
[포토] 루나솔라, 요정들의 상큼한 출근길	일간스포츠
루나, 11자 복근 돋보이는 비키니 자태 "신상 예쁘지?"	매일경제
“다 다버린대도 좋아” 핫펠트, 관능적인 변신 ‘라 루나’[들어보고서]	뉴스엔
힐링 MMORPG '루나 모바일', 28일부터 프리오픈테스트	파이낸셜뉴스
루나, 속옷 위에 재킷만 툭…이렇게 섹시했었나 [★SHOT!]	OSEN
에프엑스 출신 루나, 싱그러운 민낯 미모..상큼한 초록빛 여신	헤럴드POP
[포토] 루나솔라, 상큼하고 귀여운 소녀들	일간스포츠
[포토] 루나솔라, 귀여운 손녀들	일간스포츠
애경 루나 '픽서 파우더 팩트' 2종 출시	신아일보
핫펠트, 이번엔 강렬 라틴…신곡 '라 루나' 프리뷰	뉴스1
[TEN 포토] 루나솔라 '귀엽게 하트 뿅'	텐아시아
T3엔터테인먼트, '루나 모바일' 31일부터 사전예약	서울파이낸스
루나솔라 유우리, 눈망울에 빠져든다 [포토엔HD]	뉴스엔
루나솔라 지안, 꽃향기나는 하트 [포토엔HD]	뉴스엔
'8월 데뷔' 루나솔라, 아이덴티티 포토 공개…정체성+매력 발산	엑스포츠뉴스
루나솔라, 귀여움 가득 출근 [포토엔HD]	뉴스엔
루나, 비키니 입고 건강미 과시 `섹시 카리스마`	매일경제
루나솔라, 데뷔 직후 관심↑…3일 엠카운트다운 첫 무대	스포츠경향
T3엔터, 루나 모바일 17일 출시…사전예약 30만명 돌파	NSP통신
LUNA 모델 '서예지' 메이크업 화보공개	비지니스코리아
LUNA 모델 '서예지' 메이크업 화보공개	비지니스코리아
루나솔라 태령-이서, 더욱 깜찍하게~ [포토엔HD]	뉴스엔
T3, 신작 MMORPG ‘루나 모바일’ FGT 8월 예고	매일경제
아마존, 신제품 무더기 공개…어떤 것 내놨나	ZDNet Korea언론사 선정
루나 모바일, 동화풍 오프닝송으로 출시전부터 인기	게임샷
제이플래닛 엔터테인먼트 첫 번째 걸그룹 루나솔라, 2일 첫 번째 싱글 앨범 ‘...	한국경제TV
루나, 등근육+각선미로 완성한 `완벽` 수영복 뒤태	매일경제
에프엑스 루나의 '검정 속옷' 패션···재킷 하나만 걸쳐도 이렇게 섹시해?	서울경제
루나솔라 유우리, 가녀린 각선미 [포토엔HD]	뉴스엔
루나솔라 태령, 자체발광 하트 [포토엔HD]	뉴스엔
애경산업, 화장품 브랜드 루나 모델로 배우 ‘서예지’ 발탁	에너지경제
동화풍 감성 힐링 신작 '루나 모바일', 9월 17일 출시…사전예약 30만 돌파	엑스포츠뉴스
에프엑스 루나, 시스루 입고 활짝 ‘시원 눈매+화사 미모’[SNS★컷]	뉴스엔
루나, 섹시한 자태 뽐내며…"우리 엑프엑스 색깔, 연보라색" 여전한 애정	마이데일리
에프엑스 출신 루나, 웹드 '반예인' OST 참여…13일 '꽃날' 발매	뉴스1
"비키니 입고, 강렬 눈빛"…핫펠트 예은, 신곡 '라 루나' 파격 이미지	마이데일리
핫펠트, ‘라 루나’ 뮤비 티저 공개…라틴에 더해진 관능미	뉴스엔
루나솔라 지안, 순백의 청순미 [포토엔HD]	뉴스엔
핫펠트, 신곡 '라 루나' 금일 공개…'새로운 라틴매혹' 서막	RPM9
[루나솔라 인터뷰]③ 유우리 “소녀시대·에이핑크 보며 K팝 가수 꿈 키워”	이데일리
핫펠트, 오늘(10일) '라 루나' 발매..히트곡메이커 라이언전과 손잡고 유혹의...	헤럴드POP
에프엑스 출신 루나, 수영복 입고 오리발 내밀기…늘씬한 11자 각선미에 심쿵	헤럴드POP
'루나 모바일', 신예 걸그룹 레드스퀘어가 부른 오프닝송 화제	엑스포츠뉴스
[포토] 루나솔라-태령, '깜찍 하트'	일간스포츠
‘노는게 제일 좋은 걸그룹’ 루나솔라, 금일 ‘SOLAR : flare’로 데뷔	bnt뉴스
T3 '루나 모바일', 프리오픈테스트 신청자 20만명 돌파	아이뉴스24
루나, 새 모델로 ‘서예지’ 발탁 … “국내 및 중국에서 브랜드 마케팅 강화...	CNB저널
루나솔라 지안, 사진포즈도 취해주는 천사~ [포토엔HD]	뉴스엔
루나솔라 유우리, 청초한 양갈래 소녀의 인사 [포토엔HD]	뉴스엔
핫펠트, 신곡 '라 루나' 프리뷰 공개...오는 10일 발매	톱데일리
루나솔라 지안, 우아한 나전칠기 원피스 [포토엔HD]	뉴스엔
루나솔라 태령, 소녀의 해맑은 인사~ [포토엔HD]	뉴스엔
핫펠트, 신곡 '라 루나' 프리뷰 공개...오는 10일 발매	톱데일리
T3, '루나 모바일' 사전예약 시작	프레스맨
루나솔라, 오늘(2일) 정식 데뷔…4色 개성 비주얼+퍼포먼스 활약 '기대'	엑스포츠뉴스
'사랑의 콜센타', 톱6X뮤지컬6 역대급 대결...24주 연속 시청률 1위	YTN
루나, 맥앤지나 화보서 청순X섹시 매력	스포츠월드
루나솔라, 상큼 미모 자랑→데뷔 소감 “예쁜 추억 만들어가요” [M+★SNS]	MBN
에프엑스 루나, 이른 아침에도 빛나는 미모… 내추럴 매력 뿜뿜 [SNS★컷]	뉴스엔
서울랜드, 언택트 '서울랜드 2020 루나 마스크 파티' 개최	부산일보
루나솔라, 상큼 미모 자랑→데뷔 소감 “예쁜 추억 만들어가요” [M+★SNS]	MBN
에프엑스 루나, 이른 아침에도 빛나는 미모… 내추럴 매력 뿜뿜 [SNS★컷]	뉴스엔
서울랜드, 언택트 '서울랜드 2020 루나 마스크 파티' 개최	부산일보
데뷔 앞둔 루나솔라, 4인4색 개인 콘셉트 포토 공개	이데일리
T3엔터테인먼트 신작 '루나 모바일' 사전예약 실시	게임포커스
루나, 유쾌+발랄 집콕 생활 공유 '꿀잼 보장 라이브	한국경제
루나, 새 모델로 '서예지' 발탁...세련되고 유니크한 아름다움	한국면세뉴스
T3, '루나 모바일' CBT 시작	전자신문
제이플래닛엔터, 첫 걸그룹 루나솔라 론칭…8월 말 데뷔	뉴스1
'루나의 알파벳' 루나, '오 나의 파트너' 촬영기 공개	한국경제
[시청률] '사랑의 콜센타' TOP6, 김준수→루나 등 뮤지컬6 이겼다…최고 20.7...	디지틀조선일보
'가장 행복한 나라' 부탄의 아이들... 뜻밖의 참담한 현실	오마이뉴스
[N샷] f(x) 루나, 파격적인 시스루 드레스…'힙스터 인증'	뉴스1
T3, 루나 모바일 CBT 종료…기대감↑	NSP통신
애경산업 메이크업 브랜드 루나의 새 모델 ‘서예지’ 발탁	베타뉴스
[루나솔라 인터뷰]② 태령 “데뷔곡 ‘노는 게 제일 좋아’, 1억뷰 달성했으면...	이데일리
[루나솔라 인터뷰]④ 지안 “‘루나솔라’ 이름 내건 단독콘서트 열고 싶어”	이데일리
지안 (루나솔라) ‘출근길, 하트를 부르는 포즈’[포토엔HD]	뉴스엔
[포토] 루나솔라-이서, '빠져드는 눈동자'	일간스포츠
아마존 클라우드 게임 서비스 ‘아마존 루나’ 공개	ITWorld
아마존 클라우드 게임 서비스 ‘아마존 루나’ 공개	ITWorld
[포토] 루나솔라의 상큼한 출근길 인사법	일간스포츠
'루나 모바일' 출시…사전예약 30만명 돌파	로이슈
LUNA 모델 '서예지'의 메이크업 화보 공개	이코노뉴스
[TEN 포토] 루나솔라 태령 '강렬한 레드'	텐아시아
루나솔라 이서-지안, 돋보기 하트와 예쁜하트~ [포토엔HD]	뉴스엔
루나솔라 유우리, 후쿠오카 소녀의 앙증맞은 하트 [포토엔HD]	뉴스엔
[포토] 루나솔라 이서, ‘상큼미 발산’	파이낸셜뉴스
루나 시스루 수영복 제안…`속옷인 줄`	매일경제
'사랑의 콜센타' 루나, 이제는 10년차 뮤지컬 배우... '찬또패싱' 뜻밖의 웃음	헤럴드POP
루나솔라 유우리, 후쿠오카 소녀의 앙증맞은 하트 [포토엔HD]	뉴스엔
[포토] 루나솔라 이서, ‘상큼미 발산’	파이낸셜뉴스
루나 시스루 수영복 제안…`속옷인 줄`	매일경제
'사랑의 콜센타' 루나, 이제는 10년차 뮤지컬 배우... '찬또패싱' 뜻밖의 웃음	헤럴드POP
애경산업 루나, 새 모델로 배우 서예지 발탁	스포츠동아
맥앤지나, 루나와 커버 작업…우아한 섹시미	스포츠월드
9월 2일 데뷔 신인그룹 루나솔라(LUNARSOLAR), 단체 컨셉 포토 공개	스타데일리뉴스
T3, 힐링 MMORPG '루나 모바일' 17일 정식 출시	청년일보
핫펠트, 히트곡메이커 라이언전과 손잡았다! 신곡 '라 루나' 발매	마켓뉴스
루나, 망사 스타킹 '속 보이는' 아찔 패션…'파격+난해'	스포츠조선
애경 루나, 픽서 파우더 팩트 선봬	파이낸셜뉴스
장꾸美 넘치는 '루나'…"나와 함께 산책 나설 평생 가족되어주개!"	F.E타임스
[오늘노래] 라이언전 만난 핫펠트, 매혹적 변신 예고하는 '라 루나'	디지틀조선일보
루나, 시스루 치마 '속 보이는' 아찔 패션…평상복 or 수영복?	스포츠조선
아마존, 클라우드 게임 시장 진출…MS·구글 등과 치열한 경쟁 예고	한국경제언론사 선정
루나솔라 ‘상큼한 소녀들’[포토엔HD]	뉴스엔
루나, 과감한 란제리 패션…"내가 가장 좋아하는 룩"	머니투데이
루나, 편안한 일상‥민낯에도 빛나는 ‘요정 비주얼’ [SNS★컷]	뉴스엔
핫펠트, 25일 '뮤콘 2020' 출격..신곡 '라 루나' 무대 공개	스타뉴스
루나솔라, 태양처럼 강렬한 출사표 '노는 게 제일 좋아'[6시★살롱]	스타뉴스
애경산업, ‘루나 픽서 파우더 팩트’ 출시	CNB저널
루나솔라, 태양처럼 강렬한 출사표 '노는 게 제일 좋아'[6시★살롱]	스타뉴스
루나, 비키니 자태로 뽐낸 건강美…돋보이는 '11자 복근'	스포츠조선
T3, 모바일 MMOPRG '루나 모바일' 출시	포모스
힐링 MMORPG '루나 모바일', 28일부터 프리오픈테스트 시작	인벤
'사랑의콜센타' TOP6, 뮤지컬6에 1점차 승리…역대급 귀호강[종합]	스포츠조선
'에프엑스 출신' 루나, 셔츠 풀어헤친 채 속옷 노출…'파격 섹시미'	마이데일리
지안x유우리 (루나솔라) ‘출근길, 예쁜 하트에 엄지 척’[포토엔HD]	뉴스엔
[포토] 루나솔라-유우리, 지안 '애교가득 하트'	일간스포츠
‘사랑의 콜센타’ 신인선, 김준수·차지연·홍지민·강홍석·루나와 뮤지컬6...	한국경제
[포토] 루나솔라-유우리, 지안 '애교가득 하트'	일간스포츠
‘사랑의 콜센타’ 신인선, 김준수·차지연·홍지민·강홍석·루나와 뮤지컬6...	한국경제
'루나 모바일' 28일 프리 오픈 테스트	더게임스데일리
[TEN 포토] 루나솔라 이서 '화려한 악세사리'	텐아시아
[TEN 포토] 루나솔라 유우리 '귀여운 소녀들'	텐아시아
[스타의잇템] 루나의 새 얼굴, 서예지	일간스포츠
[포토] 루나솔라 권지은, ‘사랑스럽게~폴짝’	파이낸셜뉴스
루나, 망사 스타킹 '속 보이는' 파격 패션…"요즘 레드가 좋다♥"	스포츠조선
'침대 위에서 몽환적 표정' 루나, 란제리 화보 눈길	스포츠조선
매출 상승세 ‘루나 모바일’… 신규 업데이트로 인기 가속화	게임샷
'침대 위에서 몽환적 표정' 루나, 란제리 화보 눈길	스포츠조선
매출 상승세 ‘루나 모바일’… 신규 업데이트로 인기 가속화	게임샷
T3, '루나 모바일' 28일 프리오픈테스트 시작	뉴스핌
애경산업, '루나X위글위글 HAPPY SONG 에디션' 출시	이지경제
루나솔라, 오늘(2일) 첫 번째 싱글 앨범 [SOLAR : flare] 발매	톱데일리
루나, '댄싱 퀸'부터 '너를 위해'까지…소름 가창력으로 매력 입증	열린뉴스통신
'10일 컴백' 핫펠트, 신곡 '라 루나' 프리뷰 공개	스타데일리뉴스
[Daily New패션·뷰티] 헤라, 루나, 삼성물산 아미 外	뉴데일리
핫펠트의 관능적 유혹…신곡 '라 루나' 뮤비 티저 공개	스포티비뉴스
신인그룹 루나솔라, 두 번째 개인 컨셉 포토 공개	아시아에이
핫펠트, 신곡 '라 루나' 뮤비티저 공개…'라틴 감각 속 매혹본능'	RPM9
신인그룹 루나솔라, 두 번째 개인 컨셉 포토 공개	아시아에이
T3엔터테인먼트 신작 '루나 모바일', 9월 17일 정식 서비스 돌입	게임포커스
[인터뷰+] 루나솔라 "서로 다른 네 명의 멤버 뭉쳐 '개성' 됐죠"	한국경제
차지연→루나, '사랑의 콜센타' 출격…트롯맨 다시 만난 김준수	뉴스컬처
핫펠트, 새 싱글 '라 루나' 프리뷰 공개…'판타지' 속 파격 라틴매력	RPM9
본격 여름 나기! 제시-김희정-루나의 써머 비치 룩	bnt뉴스
T3 ‘루나 모바일’, 협동 매력 강화! 월드보스 업데이트	헤럴드경제
T3 '루나 모바일' 28일 프리오픈테스트 시작	EBN
루나솔라 태령 ‘우아한 분위기’[포토엔HD]	뉴스엔
루나솔라 태령 ‘우아한 분위기’[포토엔HD]	뉴스엔
‘사랑의 콜센타’ 신인선, 김준수·차지연·홍지민·강홍석·루나와 뮤지컬6...	스포츠조선
신예 루나솔라, '유희열의 스케치북' 오늘(25일) 첫 출연···대세 신인 입증	서울경제
T3엔터테인먼트 신작 '루나 모바일' 오프닝 송 화제	게임포커스
루나 모바일, 28일부터 프리오픈테스트	게임샷
루나, 드라마 '우아한 친구들' 네 번째 OST 주자로 참여...'Cheers' 발매	미디어리퍼블릭
루나, 섹시한 레드 보디슈트 '탄탄 보디라인'	뉴스컬처
루나 모바일, 양대 마켓 대상 사전예약 시작	청년일보
애경산업, 루나 픽서 파우더 팩트 출시…보송·매끈 피부표현	아주경제
신예 루나솔라, 아이덴티티 포토 공개…다채로운 매력	뉴스1
루나 모바일, 양대 마켓 대상 사전예약 시작	청년일보
애경산업, 루나 픽서 파우더 팩트 출시…보송·매끈 피부표현	아주경제
신예 루나솔라, 아이덴티티 포토 공개…다채로운 매력	뉴스1
T3, 확 달라진 ‘루나 모바일’ 사전오픈	디지털데일리
[SR유통] 애경산업 루나, '서예지 메이크업 화보' 공개	SR타임스
'사랑의 콜센타' 임영웅vs김준수, 역대급 빅매치…대접전 끝 TOP6 승리	한국경제
T3 힐링 MMO ‘루나 모바일’ 11시 정식 론칭	헤럴드경제
한글날 연휴 가볼만한 곳…서울랜드, 문인열전 초성 글짓기 대회 등 한글날 행...	디지틀조선일보
루나, 어느 각도에서도 빛나는 미모…화보 장인 맞네	스포츠월드
[TEN 포토] 루나솔라 지안 '햇빛도 질투하는 미모'	텐아시아
루나 맞아?…‘맥앤지나’로 처음보는 몽환적 섹시미	스포츠월드
[TEN 포토] 루나솔라 지안 '햇빛도 질투하는 미모'	텐아시아
핫펠트, 25일 '2020 서울국제뮤직페어' 출격…신곡 '라 루나' 무대 공개	엑스포츠뉴스
[TEN 포토] 루나솔라 '하트 뿅뿅'	텐아시아
루나, 선명한 복근 빛나는 비키니 자태..파격 행보ing	스타뉴스
루나솔라 이서 '유스케' 본방 기대해 주세요	뉴스1
[포토] 루나솔라 태령, ‘시원하게 드러낸 어깨’	파이낸셜뉴스
걸그룹 LUNARSOLAR(루나솔라), 아이덴티티 포토 공개	한국경제TV
출시 초읽기, T3 신작 루나 모바일 28일 테스트 시작	게임메카
루나솔라 태령 '유희열의 스케치북'	서울경제
출시 초읽기, T3 신작 루나 모바일 28일 테스트 시작	게임메카
루나솔라 태령 '유희열의 스케치북'	서울경제
"이번에는 라틴이다" 핫펠트, 파격 변신 속 신곡 '라 루나' 공개	일요신문
메이크스타X루나솔라, 영통 이벤트로 '전 세계' 팬 만난다	더리더
루나, 보송한 마무리감 주는 '픽서 파우더 팩트' 2종 출시	더퍼스트
핫펠트, 라이언전과 손잡았다...오늘(10일) ‘라 루나((La Luna)’ 발매	MBN
루나, '우아한 친구들' 네번째 OST 가창…31일 'Cheers' 발매	조이뉴스24
T3, '루나 모바일' 유저와 함께 만든다…8월 중 전격 'FGT'	게임조선
‘슈퍼 전파’ 된 배럿 지명식… 트럼프 최측근 줄줄이 코로나 확진	서울신문언론사 선정
장비 뽑기 없는 ‘루나 모바일’, 원작 감성 ‘진짜’ 담았다	매일경제
아마존, 클라우드 게임 서비스 '루나' 공개	게임톡
루나, 볼륨감 자랑하는 파격 노출 ‘이렇게 섹시했나?’[SNS★컷]	뉴스엔
"저 멀리 달 끝까지" 핫펠트, 늦여름 떠나는 매혹의 바캉스 '라 루나' [퇴근길...	OSEN
T3, ‘루나 모바일’ 31일부터 사전예약	스포츠경향
트럼프 주치의 "대통령에게 '렘데시비르' 투약 시작했다"	조세일보
T3엔터, 신작 ‘루나 모바일’ 오는 28일 프리오픈테스트	매일경제
애경산업, 신제품 '루나 픽서 파우더 팩트' 출시	빅데이터뉴스
T3, 28일부터 '루나 모바일' 프리오픈테스트 시작	게임조선
루나, 완벽 비키니 자태... 건강미↑	TV리포트
에프엑스 루나, 내추럴 미모 폭발..청순함에 심쿵	헤럴드POP
에프엑스 루나, 내추럴 미모 폭발..청순함에 심쿵	헤럴드POP
루나, 수영복 입고 탄탄한 몸매 인증 "처음 배워 본 수영"	마이데일리
'루나 모바일' 프리오픈테스트 유저 20만명 신청	게임조선
T3, 힐링 MMOPRG '루나 모바일' 정식 출시	뉴스핌
루나, 감탄을 불러일으키는 도발+섹시美	enews24
루나솔라 ‘심플리케이팝 녹화 왔어요~’[포토엔HD]	뉴스엔
루나, 검정 비키니에 '건강미' 뽐내	MBN
신예 루나솔라, 프로야구 야구장 광고판에 떴다…이색 홍보	뉴스1
이달의 소녀(LOONA), '와이낫?' 온라인콘서트 통해 팬들과 만남	시사포커스
애경, 루나 크리스탈 베이비 부스터 '첫 선'	파이낸셜뉴스
힐링 MMOPRG '루나 모바일' 정식 출시	테크월드
루나, 핫핑크도 찰떡 소화…바비인형 비주얼 '감탄' [★해시태그]	엑스포츠뉴스
루나 모바일, 프리오픈테스트 유저 20만명 신청	게임샷
루나, 과감한 브라톱+핫팬츠 `섹시美` [똑똑SNS]	MK스포츠
신인 걸그룹 루나솔라, 데뷔 전 쇼핑라이브 모델로 참여	한국경제TV
"내가 이상한가요?"…루나솔라, 개성 만점 데뷔 출사표 '노는 게 제일 좋아' ...	엑스포츠뉴스
[TEN 포토] 루나솔라 유우리-지안 '상큼 발랄하게~'	텐아시아
'더 킹' 이민호, 루나 김고은 '독살' 테러'에 쓰러졌다…앞으로의 운명은?	한국경제
아마존, 게임 스트리밍 서비스 '루나' 공개…구글·MS 격돌	더구루
힐링 MMORPG '루나 모바일', 프리오픈 테스트 일정 발표	엑스포츠뉴스
[포토] 루나솔라 이서-태령, ‘상큼 요정들의 인사’	파이낸셜뉴스
루나솔라 태령 '지퍼 가죽초미니로 상큼하게'	뉴스1
루나, 과거 공황장애 고백 "인신공격 악플이‥손 발이 떨려서"	뉴스컬처
'루나 모바일' 9월17일 출시 확정…사전예약 30만명 돌파	프레스맨
루나, '반예인' 마지막 OST 참여..'꽃날' 오늘(13일) 발매	스타뉴스
루나, 속옷 연상룩 위에 시스루 치마 "내가 좋아하는 사진"	스포츠조선
'사랑의 콜센타' 루나, '댄싱 퀸'부터 '너를 위해'까지…소름 가창력으로 매...	한국면세뉴스
루나, 란제리 화보 공개…"완벽한 시스루 룩"	머니투데이
루나, 망사+레드로 뽐낸 섹시美…요염한 자태에 숨멎	헤럴드POP
‘우아한 친구들’ OST 풀트랙 발매…‘장혜진-루나-이찬솔 참여’	한국경제TV
루나 새 모델로 ‘서예지’ 발탁	스타뉴스
T3, '루나 모바일' 7월 중 프리오픈테스트 실시	아이뉴스24
루나, '신상 비키니' 입고 한여름 패션 뽐내	MBN
T3, '루나 모바일' CBT 돌입	이뉴스투데이
'더킹' 이정진, 루나(김고은)에게 '새 삶' 선물	스타뉴스
루나솔라, 9월 2일 데뷔 일자 확정···보컬 퍼포먼스 그룹 새 지평 연다	서울경제
힐링 MMORPG '루나 모바일' 28일부터 프리오픈테스트 진행	게임조선
‘사랑의 콜센타’ 김준수, 임영웅 꺾고 역전 성공	매일경제
핫펠트, 25일 '2020 서울국제뮤직페어' 출격…신곡 '라 루나' 무대 공개	한국경제TV
핫펠트, 라이언전과 손잡았다…오늘(10일) 신곡 '라 루나' 발매	컨슈머타임스
루나, '우아한 친구들' OST…"한껏 신나는, Cheers"	디스패치
애경산업, '루나X위글위글 해피송 에디션' 출시	컨슈머타임스
'믿고 듣는' 루나, 웹드라마 반예인 OST '꽃날' 참여…13일 발매	엑스포츠뉴스
T3엔터, 모바일 MMORPG ‘루나 모바일’ 테스트에 20만명 신청	매일경제
제이플래닛엔터 걸그룹 팀명 루나솔라 확정…8월 데뷔	이데일리
T3, 28일부터 '루나 모바일' 프리오픈테스트 시작	게임샷
핫펠트, 10일 신곡 '라 루나' 발표…관능+독보적 사운드	조이뉴스24
'우아한 친구들' OST 풀트랙 발매...장혜진-루나-이찬솔 참여한 OST 수록	한국경제
[글로벌] 아마존, 클라우드 게임 서비스 '루나' 발표	테크M
'8월말 데뷔' 루나솔라, 4색 매력	뉴스컬처
'8월말 데뷔' 루나솔라, 4색 매력	뉴스컬처
루나, 다이어트 욕구 자극 '섹시+러블리' 수영복 자태 '감탄' [★해시태그]	엑스포츠뉴스
칼로커트, 겟레디윗미서 루나의 다이어트 비결로 소개	세계비즈
동화풍 힐링 MMORPG '루나 모바일' 31일부터 사전예약	인벤
T3, '루나 모바일' 유저와 함께 만든다	이뉴스투데이
NHN벅스X제이플래닛, 첫 걸그룹 '루나솔라' 론칭	더팩트
'사랑의 콜센터' 임영웅vs김준수→장민호+차지연 '홍연' 화제	MBC연예
루나, 레드 보디슈트 입고 '강렬 카리스마' 발산	MBN
후오비코리아, 테라 마이닝 토큰 '루나(LUNA)' 상장	스포츠서울
T3, '루나 모바일'에 월드 보스 선보인다	디스이즈게임
루나솔라 이서 '유희열의 스케치북' 출근길	서울경제
루나솔라 지안 '유희열의 스케치북' 출근길	서울경제
루나, 노출 없어도 섹시..살짝 보이는 잘록 허리	헤럴드POP
에프엑스 출신 루나, 손끝까지 우아한 포즈..옆태만 봐도 예뻐	헤럴드POP
루나, ‘핫팬츠 위 망사 스타킹’ 파격 패션	한국일보
루나, 메이크업 고정 돕는 '픽서 파우더 팩트' 출시	머니투데이
MS는 게임회사 9조에 인수하고 아마존은 클라우드 게임 진출	서울경제
'루나 모바일' 프리오픈테스트 시작	더게임스데일리
루나, 속옷도 패션? 파격적인 시스루 스커트 '아찔'	마이데일리
'낰낰낰' 루나솔라, '포월스'부터 '노는게 제일 좋아'→단 세곡 매력폭발[종합...	OSEN
'낰낰낰' 루나솔라, '포월스'부터 '노는게 제일 좋아'→단 세곡 매력폭발[종합...	OSEN
[뉴스투데이 L] 서예지, 애경산업 ‘루나’ 모델로 선정	뉴스투데이
"데뷔 하자마자 서버 다운"…루나솔라, 핫루키 등장	TV리포트
'미스터트롯' 진 임영웅 VS 마스터 김준수, 승자는? | '사랑의 콜센타' 뮤지컬...	topclass
'더 킹' 이민호, 과거 비밀 풀었지만…'루나' 김고은에 당했다 [종합]	엑스포츠뉴스
핫펠트, 오늘(10일) 신곡 '라 루나' 발매..'관능 판타지'	스타뉴스
루나솔라, 오늘(2일) 공식 데뷔 …첫 번째 싱글 앨범 'SOLAR : flare' 발매	매일일보
T3, 루나 모바일 유저와 소통 운영…8월 중 FGT 진행	NSP통신
애경산업 ‘루나’ 새 모델 서예지 발탁	보건뉴스
후오비코리아, 테라 마이닝 토큰 '루나' 상장	데이터넷
후오비코리아, 테라 마이닝 토큰 '루나' 상장	데이터넷
T3 ‘루나 모바일’ 오프닝송 화제…신인 걸그룹 ‘레드스퀘어’ 불러	NSP통신
'D-1' 핫펠트, 새 싱글 '라 루나' MV 티저 공개…"관능+섹시"	컨슈머타임스
루나 모바일, 프리 오븐 테스트 8월 3일까지 진행	포모스
애경산업, 루나 새 모델로 '서예지' 발탁	메트로신문
루나 ‘데일리 크러쉬 아이 섀도우 팔레트’ 출시	보건뉴스
T3, 힐링 MMOPRG '루나 모바일' 정식 출시	파이낸셜투데이
루나, 구릿빛 섹시 글래머 몸매 "우리 에프엑스 색깔 연보라색"	헤럴드POP
루나, ‘반예인’ OST ‘꽃날’로 감성 전한다	파이낸셜뉴스
루나솔라, 아이덴티티 포토 공개… 압도적 비주얼	이데일리
루나솔라, 아이덴티티 포토 공개… 압도적 비주얼	이데일리
루나 참여 '우아한 친구들' OST 'Cheers', 오늘(31일) 발매	베리타스알파
[N시청률] '사랑의 콜센타' 김준수, 임영웅과 역대급 빅매치 끝 승리 '18.3%'	뉴스1
마스크쓰고 하는 언택트 축제 열린다	한국경제
루나, 그림같은 옆태…우아한 모습에 '시선 강탈' [★해시태그]	엑스포츠뉴스
포즈 취하는 루나솔라 태령-이서-유우리-지안	서울경제
[인터뷰] 데뷔 일주일 맞은 루나솔라 "우린 노는 게 제일 좋아"	서울경제
애경산업 ‘루나’, 신제품 픽서 파우더 팩트 출시	쿠키뉴스
'사랑의 콜센타' 루나, '댄싱 퀸'부터 '너를 위해'까지! 소름 가창력으로 매...	엔터미디어
T3, 힐링 MMOPRG '루나 모바일' 정식 출시	디스이즈게임
'사랑의 콜센타' 루나, '댄싱 퀸'부터 '너를 위해'까지! 소름 가창력으로 매...	엔터미디어
'사랑의 콜센타' TOP6 임영웅 vs 뮤지컬6 김준수 대결 성사	더팩트
T3, 힐링 MMOPRG '루나 모바일' 정식 출시	디스이즈게임
T3엔터테인먼트, '루나 모바일' 17일 출시	파이낸셜투데이
"이번엔 라틴이다" 핫펠트, 파격 변신 속 신곡 '라 루나' 기대 UP↑	컨슈머타임스
다양한 호재 갖춘 신독산역 오피스텔 루나플라체 분양	서울경제
신인선, 김준수·차지연·홍지민·강홍석·루나와 뮤지컬6 결성	enews24
아마존, 클라우드 게임 경쟁에 합류하다··· ‘루나’ 서비스 이모저모	CIO Korea
에프엑스 루나, 시스루 치마 사이로 보이는 아찔 패션[똑똑SNS]	MK스포츠
루나, 비키니 입고 뽐낸 11자 복근…파격 섹시美	마이데일리
루나 모바일 프리오픈테스트에 유저 20만명 신청	NSP통신
핫펠트, 오늘(10일) '라 루라' 공개…라이언전 지원사격	텐아시아
애경산업 루나 픽서 파우더 팩트 출시	EBN
교통·수요·설계 투자의 3박자를 갖춘 오피스텔 루나플라체	파이낸스투데이
'사랑의 콜센타' 임영웅vs김준수, 역대급 최강 가창력 대결→안방 흥 폭발!	여성조선
'더 킹' 이정진, '루나' 김고은와 대면 "내가 인복은 있구나"…거래 제안	헤럴드POP
스트리밍 게임시장, '아마존 태풍' 경계경보	이코노믹리뷰
애경산업 루나, 브랜드 모델로 ‘서예지’ 발탁	FETV
[TEN 포토] 루나솔라 태령 '흘러 넘치는 청순미'	텐아시아
'더킹' 이민호, 루나 김고은 독살 테러에 쓰러졌다…절체절명 충격 엔딩	SBS funE
[TEN 포토] 루나솔라 태령 '흘러 넘치는 청순미'	텐아시아
'사랑의 콜센타' 차지연→김준수, '트로트6'와 대결 성사…명승부 향연(종합)	뉴스1
'더킹' 이민호, 루나 김고은 독살 테러에 쓰러졌다…절체절명 충격 엔딩	SBS funE
T3, '루나 모바일' CBT 시작	프라임경제
루나 모바일, 7월 프리오픈테스트	게임샷
루나, 매혹적 비주얼에 심쿵 "매일 매일 나 자신을 사랑해주기"	헤럴드POP
힐링 MMORPG '루나 모바일' 사전예약 진행	테크월드
루나 "New 신상 수영복 이뿌디?" 군살 제로 바디라인 '눈길'	인천일보
루나, 파격적 스타일링..섹시한 매력이 한도 초과	헤럴드POP
루나, 올블랙 의상으로 뽐낸 걸크러시 매력[SNS★컷]	뉴스엔
T3엔터테인먼트, 루나 모바일 28일부터 프리오픈테스트	NSP통신
애경산업 루나, 새 모델로 배우 '서예지' 발탁	컨슈머타임스
에프엑스 루나, 가슴골 깊게 파인 섹시한 의상..섹시美 뿜뿜	헤럴드POP
T3, 28일부터 '루나 모바일' 프리오픈테스트 시작	NSP통신
T3, '루나 모바일' 이달 중 포커스그룹테스트 실시	한국정책신문
루나, 브라탑+핫팬츠 파격 패션보다 섹시한 보디라인	매일경제
신인그룹 루나솔라, 9월 2일 데뷔 확정! 두 번째 개인 컨셉 포토 공개	엔터미디어
'사랑의 콜센타' 임영웅vs김준수, 역대급 빅매치…불꽃 튀는 '대접전' TOP6 승...	스포츠조선
'사랑의 콜센타' 뮤지컬 간판스타 김준수x차지연x홍지민x강홍석x루나x신인선 ...	MBN
루나의 깜짝 노래 선물, ‘어떻게 이별까지 사랑하겠어, 널 사랑하는 거지’ ...	한국경제TV
'루나 모바일' 17일 출시…사전예약 30만명 돌파	글로벌이코노믹
백악관 “코로나19 증상 나타나면 사라질 때까지 출근 중단”…전 직원에 통보	세계일보
루나 "Coming soon" 남심 강탈 아우라 과시 '눈길'	인천일보
T3 ‘루나 모바일’ 국내 론칭 … 원작 감성, ‘함께’하는 재미 담았다	헤럴드경제
T3, ‘루나모바일’ 7월 프리오픈테스트 실시	매일경제
루나, 파격 망사 스타킹으로 '섹시미' 폭발…아찔+도도 [in스타]	엑스포츠뉴스
'루나 모바일', 프리오픈테스트 유저 20만명 신청…'차별화된 힐링 MMORPG'	엑스포츠뉴스
도심 호텔·테마파크 "한가위 특수도 실종"…고객잡기 '안간힘'	뉴스1
루나, 속옷 아닌 시스루 패션? 파격+과감 스타일링 '눈길' [★해시태그]	엑스포츠뉴스
'라이브 형 아이돌' 루나솔라, 9월 2일 정식 데뷔	뉴스컬처
제이플래닛 엔터테인먼트, 첫 번째 걸그룹 LUNARSOLAR(루나솔라) 론칭…8월 말...	한국경제TV
[영상]'사랑의 콜센타', 김준수→루나 등 뮤지컬 간판스타 6人 출격…TOP6와 ...	디지틀조선일보
T3 '루나 모바일' CBT 시작…3000여명 참여	EBN
T3엔터테인먼트, '루나 모바일' 17일 출시	이뉴스투데이
루나, 다채로운 매력의 란제리룩 "찰떡같이 잘 맞아"	머니S
루나, 수영복 입고 뽐낸 건강미..개미허리+애플힙 완벽 몸매[★SHOT!]	OSEN
T3, 힐링 MMORPG '루나 모바일' 7월 프리오픈테스트	이뉴스투데이
'더 킹' 김경남, 루나 김고은 기습키스에 '심쿵'…입체적 열연	한국경제
루나, 과감한 시스루 치마로 반전매력 "내가 좋아하는 사진♥"	스타뉴스
루나, 탄탄한 보디라인+몽환적 눈빛... 다양한 매력 [화보]	스타데일리뉴스
루나, 입술 쭉 내밀고 '찰칵'…"노래 연습 열심히" [★해시태그]	엑스포츠뉴스
T3, '루나 모바일' 28일부터 프리오픈테스트 진행	한국정책신문
NHN벅스 첫 걸그룹 ‘루나솔라’ 8월 데뷔	스포츠한국
T3 '루나 모바일' CBT 신청자 3000명 넘어	더게임스데일리
경마계 탑골 열풍…루나·아름다운질주·미스터파크'	뉴스핌
가수 루나, 귀여운 캐릭터와 함께 찰칵..날렵한 턱선	헤럴드POP
힐링 MMORPG '루나 모바일' 7월 프리오픈테스트	게임조선
루나솔라, 개인 콘셉트 포토 공개…데뷔 기대되는 '힙'한 매력	스포티비뉴스
브라톱에 핫팬츠…루나, 의상이 점점 과감해지네	마이데일리
T3 '루나 모바일' CBT 종료	더게임스데일리
핫펠트, 신곡 '라 루나' 프리뷰 공개! 강렬 라틴 사운드	열린뉴스통신
에프엑스 루나, 청순&섹시 고혹적인 주얼리룩 '시선 강탈'	패션엔
루나, 우아한 옆태+가녀린 어깨 …여신 비주얼 완성 [★해시태그]	엑스포츠뉴스
"아찔"…루나, 보디슈트 입고 섹시미 폭발	마이데일리
힐링 MMORPG '루나 모바일' 28일부터 프리 OBT	인벤
루나, 악동뮤지션 '어사널사' 커버 영상 공개 "팬들 위한 선물"	마이데일리
'사랑의 콜센타' TOP6vs뮤지컬6, 가창력+웃음+감동의 레전드 매치 탄생	엑스포츠뉴스
루나솔라 태령-이서-유우리-지안 '유희열의 스케치북' 출근길	서울경제
루나솔라, '뮤직뱅크' 데뷔 무대 후 10대 실검 1위…뜨거운 관심	뉴스1
[2020년 9월4주차] 이주의 코스메틱 신제품은?	문화저널21
루나X초이, '어떻게 이별까지 사랑하겠어' 커버…라이브 듀엣에 관심↑	엑스포츠뉴스
[2020년 9월4주차] 이주의 코스메틱 신제품은?	문화저널21
[망원경 인문강좌] 1년 동안 니체…<안티크리스트>(1)	울산저널
루나솔라, 정식 데뷔 전부터 광고계 러브콜···"쇼핑라이브 모델 발탁"	서울경제
"레드가 좋다"…루나, 파격 의상+과감 포즈	TV리포트
신작 ‘루나 모바일’, 25일까지 비공개 테스트 실시	매일경제
힐링 MMORPG '루나 모바일' 28일부터 프리오픈테스트	매일일보
서예지, 핑크 카디건 입고…"사랑스러운 매력"	머니투데이
핫펠트, 신곡 ‘라 누나’ 프리뷰 공개…관능+섹시미 발산	MBN
T3 ‘루나 모바일’ 7월 프리오픈테스트 진행	이코노믹리뷰
트럼프 최측근 수행원도 코로나19 확진…백악관 내 감염 확산	MBN
‘더킹’ 김경남, ‘루나’ 김고은 기습키스에 심쿵..고백 못하는 아픈 사랑	OSEN
루나, 과감한 시스루 드레스 공개…패션 힙스터	TV리포트
루나 모바일, CBT 시작…유저 3000여명 몰려	게임샷
NHN벅스 레이블 제이플래닛, 첫 걸그룹 ‘루나솔라’ 론칭	데일리안
루나, 명품 비키니+구리빛 몸매+도발 눈빛 '파격적 치명美'	스포츠조선
[세계NOW] "美아르테미스 프로젝트, 세계 각국이 달탐사 경쟁 나선 이유"	YTN
루나, 화장기 제로에도 빛나는 비주얼‥아이돌은 역시 달라	헤럴드POP
‘클라우드 게임’ 나 빼면 곤란하지…아마존도 본격 참전	디지털데일리
T3 신작 ‘루나 모바일’ 테스트 ‘성료’	매일경제
[단독] '사랑의 콜센타' 김준수·차지연·신인선·강홍석·루나, 뮤지컬특집 ...	엑스포츠뉴스
모바일 MMORPG '루나 모바일', 내달 출시 앞두고 사전예약 시작	포모스
에프엑스 루나, 파격 수영복 차림 공개.. 얇은 시스루 아래로 ‘아찔’	세계일보
[SC리뷰]"역시 마스터 클래스"…'사랑의콜센터' 김준수, 임영웅과 역대급 빅매...	스포츠조선
루나, '반예인' OST 마지막 가창자 발탁…13일 '꽃날' 음원 공개	마켓뉴스
루나 "촬영장 가는 길♥" 시크+도도 아우라 과시	인천일보
힐링 MMORPG '루나 모바일' 17일 양대 마켓 정식 출시	청년일보
'우아한 친구들' OST 풀트랙 발매.."장혜진-루나-이찬솔 참여한 OST 수록"	헤럴드POP
T3엔터테인먼트 '루나 모바일' 7월 프리오픈테스트	EBN
태령 (루나솔라) ‘도도한 매력’[포토엔HD]	뉴스엔
애경산업 루나 '데일리 크러쉬 아이 섀도우 팔레트' 출시	천지일보
제이플래닛 新 걸그룹 루나솔라(LUNARSOLAR), 8월 데뷔 확정 [공식입장]	엑스포츠뉴스
루나, 웹드라마 '반예인' OST 피날레 장식…신곡 '꽃날' 금일 공개	RPM9
루나모바일, 8월 중 유저 초청 테스트 진행하기로	인벤
트위치의 아마존까지 등판...치열한 클라우드 게임 대전	이코노믹리뷰
루나, '픽서 파우더 팩트' 출시	한국정책신문
쿠론, 60년대 레트로무드 신상품 출시	뉴시스
[뷰튜버 경제] 뷰티업계, 크리에이터 앞세워 MZ세대 사로잡아라	아주경제
에프엑스 루나, 운동 욕구 자극하는 `탄탄몸매`[똑똑SNS]	MK스포츠
'사랑의 콜센타' 임영웅→김준수, 최강 가창력+저세상 텐션..시청률 18.3% 기...	헤럴드POP
핫펠트의 관능적 유혹! 신곡 '라 루나' M/V 티저 공개..	열린뉴스통신
[더파워] 신인 걸그룹 루나솔라, 9월 데뷔 확정…두 번째 개인 컨셉 포토 공개...	더파워
루나, 시스루 스커트 입고…속 보이는 ‘아찔’ 패션 [스타★샷]	스포츠월드
[영화선우] ‘교실 안의 야크’, 행복은 무엇일까?	뉴스민
루나, 명품백으로 자랑한 세련 미모…"재밌는 일 가득, 뿌듯하고 기뻐"	헤럴드POP
T3, '루나 모바일' 28일부터 프리오픈테스트	프레스맨
[리뷰] 귀여움은 기본. 부담없는 힐링 판타지 꿈꾸는 루나 모바일	게임동아
셀카 사진 올리며 보고 싶은 故 설리 태그한 '에프엑스' 크리스탈X루나	인사이트
9월 25일 유희열의 스케치북…10CM, 하동균, The BLANK ShopX이진아, 루나솔라...	디지틀조선일보
애경산업 루나, 새 모델 서예지 메이크업 화보 공개	천지일보
에프엑스 루나, 물오른 성숙美..핫핑크 정장도 완벽 소화	헤럴드POP
T3 신작 '루나 모바일' 프리오픈테스트 유저 20만명 신청	매일일보
루나 모바일, 8월 중 FGT로 이용자와 소통 나서	청년일보
루나, 매일이 러블리한 일상 "날씨가 정말 좋다" [★해시태그]	엑스포츠뉴스
[인터뷰] 루나솔라 "뽀로로가 라이벌? '노는 게 제일 좋아' 함께 들어주셨으면...	한국경제
루나 "모두 마무리 되었당" 순백의 아우라로 뽐낸 청순美	인천일보
루나솔라 태령, 소녀감성 [포토엔HD]	뉴스엔
T3, '루나 모바일' CBT 종료…기대감 증폭	게임조선
루나, 스타일리시한 핏에 심쿵…화려한 비주얼은 덤	헤럴드POP
트럼프 최측근 수행원도 감염…백악관 내 코로나19 초비상	매일경제
트럼프 최측근 수행원도 감염…백악관 내 코로나19 초비상	매일경제
T3, 힐링형 RPG '루나 모바일' 정식 출시	뉴스웍스
'사랑의 콜센타' 루나, '댄싱 퀸'·'너를 위해' 가창력 과시…막내 자존심 지...	뉴스웍스
[TD포토] 루나솔라 '안녕~'	티브이데일리
루나솔라 '인형같은 비주얼' [영상]	스타뉴스
'사랑의 콜센타' 차지연X장민호, '홍연' 특별무대 '역대급 귀호강'→ TOP6 최...	MBC연예
유우리 (루나솔라) ‘컬러풀한 매력’[포토엔HD]	뉴스엔
루나, 푹 파인 핑크룩으로 섹시+상큼美 폭발 ‘예쁘다 예뻐’[SNS★컷]	뉴스엔
신작 모바일 RPG '시노니스', 시리리·탐욕시리리·루나·메이 캐릭터 4종 공...	엑스포츠뉴스
루나솔라 이서, 핑크빛 볼하트 [포토엔HD]	뉴스엔
루나솔라 이서, 핑크빛 볼하트 [포토엔HD]	뉴스엔
T3, 루나 모바일 7월 프리오픈테스트 예정	NSP통신
루나솔라 태령, 사랑스러운 하트 [포토엔HD]	뉴스엔
'루나 모바일' 9월17일 출시…사전 예약 30만 돌파	디스이즈게임
T3, '루나 모바일' 유저와 함께 만든다…8월 중 '집중그룹테스트'	매일일보
[종합] '사랑의 콜센타' TOP6, 뮤지컬6 꺾고 최종 승리... '역대급' 귀호강 듀...	헤럴드POP
루나, 신상 비키니 입고 뽐낸 11자 복근 "예쁘지?"	스타뉴스
에프엑스 루나, 속옷이야 수영복이야? '깜짝' 시스루 패션	스포티비뉴스
'루나 모바일' 프리오픈테스트 유저 20만명 신청	로이슈
에프엑스 출신 루나, 파격 메이크업으로 시선강탈..그저 감탄 또 감탄	헤럴드POP
테스트 마친 T3엔터테인먼트 '루나 모바일', 이용자 의견 적극 반영한다	게임포커스
에프엑스 출신 루나, 파격 메이크업으로 시선강탈..그저 감탄 또 감탄	헤럴드POP
루나솔라 지안, 청순가득 손 인사 [포토엔HD]	뉴스엔
루나솔라 이서, 앙증맞은 하트 [포토엔HD]	뉴스엔
‘노는 게 제일 좋아’ 루나솔라 데뷔에 소속사 홈페이지 트래픽 초과…관심 ...	MTN
루나, 크리스탈 베이비 부스터 출시	이코노뉴스
에프엑스 출신 루나, 탄탄 일자 복근..신상 비키니 입고 예뻐졌네	헤럴드POP
루나, 구릿빛 피부에 완벽 수영복 자태 공개	MBN
루나 모바일, CBT 종료…기대감 증폭	게임샷
'사랑의 콜센타' 김준수-차지연-홍지민-강홍석-루나-신인선 출격, 뮤지컬 배우...	스타데일리뉴스
루나, 도심 한복판에서 비키니 입고..아찔 섹시美	헤럴드POP
임기원과 찰떡궁합 화이트퀸, '제2의 루나'로 주목	일간스포츠
LUNA ‘서예지’의 ‘로지&코랄 메이크업’	스타뉴스
4인조 루나솔라 데뷔 "보컬 기반 퍼포먼스 그룹"	뉴스컬처
[Daily New패션·뷰티] LG생활건강, 노스페이스, 코오롱FnC	뉴데일리
루나 "매일 매일 나 자신을 사랑해주고" 청초함으로 뽐낸 세련美	인천일보
[TD포토] 루나솔라 '하트 뿅뿅~'	티브이데일리
루나, 'V라인 미모' 리즈 찍었다 "매일 나 자신 사랑…자존감 높이기" [★해시...	엑스포츠뉴스
이서 (루나솔라) ‘출근길도 화보처럼’ [포토엔HD]	뉴스엔
루나솔라 지안, 상암에 내려온 천사 [포토엔HD]	뉴스엔
