이시영, 패션의 완성은 명품백..오늘은 '사복 요정'	헤럴드POP
이시영, 가을햇빛 맞으며 싱그러운 한때 "가을에 좋아요!"	일간스포츠
'프로 등산러' 이시영, 수락산 끝판왕 도전 "건강할 때 등산…마음 비워내" [...	엑스포츠뉴스
'나는살아있다' 0.1% 특전사 박은하→김민경·김성령·이시영, 카리스마 폭발	스포츠조선
'정윤맘' 이시영, 명품백 메고 상큼한 미소 '20대 같아' [★해시태그]	엑스포츠뉴스
“걸어서 경기도-강원도 거리” 이시영, 명성산 정상서 찰칵 [SNS★컷]	뉴스엔
이시영, 모자 쓰고 귀여움 뽐내…남다른 패션 센스 [★해시태그]	엑스포츠뉴스
이시영, 추운 날씨에도 포기 못하는 핫팬츠..애엄마 안믿기는 늘씬 각선미[★...	OSEN
이시영, 애엄마의 완벽한 각선미..주말마다 운동 괜히 한게 아니네	헤럴드POP
"상상도 못했다"..'나는 살아있다', 김성령·이시영→우기 생존도전기	enews24
이시영, 아들 향한 ♥.."천일 축하해" [스타IN★]	스타뉴스
"살고 싶으면 배워라" '나는 살아있다' 김성령X이시영 캐릭터 티저 공개	OSEN
이시영, 아들 천일 기념 독특 케이크 ‘문구 모양+꽃 장식’[SNS★컷]	뉴스엔
이시영, 숏팬츠·부츠도 완벽 소화…롱다리 미녀 인증 [★해시태그]	엑스포츠뉴스
이시영, 엄마의 도발..샤론스톤 뺨치는 섹시한 다리꼬기	헤럴드POP
이시영, 탄탄 보디라인...`건강美 여신`	매일경제
이시영, 하의실종 패션으로 뽐낸 명품 각선미 “반하겠어” [SNS★컷]	뉴스엔
이시영, 블랙 원피스 입고 청순美 뽐내	스타뉴스
이시영, 틱톡 근육男 등장에 `휘둥그레`..."찍으면서 행복했다"	매일경제
이시영, 애엄마 맞아?…자기관리로 완성한 각선미→'하의실종 몸매'	스포츠조선
이시영, 패셔니스타의 가을 분위기 내기…멋스러운 워킹맘	헤럴드POP
"김성령→이시영" '나는 살아있다', 비장한 메인포스터 공개	텐아시아
'등산 요정' 이시영, 트렌디한 패션에 가을 느낌 물씬..언제나 예쁜 '아들 맘...	헤럴드POP
이시영, 늘씬한 완벽 비율에 '심쿵'...청순美 '뿜뿜'	뉴스컬처
김성령→이시영 ‘나는 살아있다’ 3분 생존 도전기 공개	스포츠동아
이시영, 이번엔 소요산 정복 ‘명불허전 등산 러버’ [SNS★컷]	뉴스엔
서울E 이시영, 부상 털고 상승세 중심..."승격 목표 이루어질 것" [오!쎈 인터...	OSEN
'아들 맘' 이시영, 롱 원피스 입으니 가을 분위기 물씬..'등산 요정'의 출근길	헤럴드POP
이시영, 베일에 감춰진 남성과 집에서 댄스타임? "혼자 잘 놀지"	헤럴드POP
김성령x이시영x김민경 tvN 생존 프로젝트 ‘나는 살아있다’ 출연 [공식]	스포츠동아
이시영, 화장기 없으니 더없이 청초..역대급 동안 미모	헤럴드POP
이시영, 가을 외출룩도 스타일리시하게! [리포트:컷]	TV리포트
"원피스X 다리근육 빼꼼" 이시영, 청순함 속에 건강美 있다 [★SHOT!]	OSEN
이시영, 20대 뺨치는 동안 미모..유부녀 맞아? [★SHOT!]	OSEN
이시영, 애 엄마 맞아?…청량美 넘치는 근황에 '그저 감탄뿐'	헤럴드POP
이시영, 스타일리시 가을 데일리룩…싱그러움 한도초과	헤럴드POP
이시영, 애엄마의 비주얼 클라스..차원 다른 청초함	헤럴드POP
이시영, 추석에 전한 수수한 근황 '러블리'	일간스포츠
이시영, 셔츠+조끼 난해 패션도 소화한 ‘명품 모델핏’[SNS★컷]	뉴스엔
이시영, 깁스한채 아빠 밥상에 폭풍먹방 "운동한 칼로리 다 회수"	일간스포츠
내가 꾸안꾸의 정석…이시영, 가을 데일리룩 이 거다[스타★샷]	스포츠월드
이시영, 산악 유튜브 채널 예고…"같이 등산 다녀요"	뉴시스
이시영, 햇빛 사이로 빛나는 싱그러운 매력	일간스포츠
'등산 요정' 이시영, 예쁜 사복 입고 즐거운 나들이..언제나 인형 비주얼♥	헤럴드POP
이시영, 라이더 자켓 입으니 가을 느낌 물씬..오늘은 '사복 요정'	헤럴드POP
이시영, 민낯도 이렇게 예쁠 일?..청순함에 또 반했네	헤럴드POP
"결혼기념일♥" 이시영, '사업가 남편'이 직접 만들어준 케이크에 감동 폭발	스포츠조선
[N샷] 이시영, 럭셔리 하우스 속 거실 인테리어 공개…깔끔	뉴스1
이시영, 사랑 듬뿍 받는 달달 결혼기념일..남편도 살짝 공개	헤럴드POP
이시영 "돈주고 살수없는 북한산 힐링..가슴이 뻥~"	일간스포츠
이시영, 워킹맘의 화려한 외출..동안 미모 자체발광	헤럴드POP
이시영, 동안 미모 종결자..수수해도 너무 예뻐	헤럴드POP
배우 이시영, 아무것도 안 하고 21억 번 비법 [집코노미TV]	한국경제언론사 선정
[오마이포토] 'SF8' 이시영, 변치않는 건강	오마이뉴스
이시영, 일상이 화보…가을 느낌 물씬나는 '패션의 완성'	스포츠조선
[포토] 건강미 넘치는 이시영	매일경제
김성령·이시영·김민경, 생존 전사 프로젝트 '나는 살아있다' 출연 확정(공식...	YTN
이시영, 대리석 식탁→드넓은 거실 '으리으리' 집 공개 [★SHOT!]	OSEN
이시영 '아름다운 미소'[엑's HD포토]	엑스포츠뉴스
"애 엄마 맞아?"..이시영, 걷는 곳이 어디든 런웨이…대학생이래도 믿을 비주...	헤럴드POP
이시영, 야외에서 마스크 벗고 셀카..더 예뻐졌네	헤럴드POP
이시영, 키즈카페 아냐?…널찍한 아들 방 사진에 오윤아도 "부럽다"	스포츠조선
이시영, 가을 느낌 물씬...`사복 여신`	매일경제
이시영 "다이어트로 시작한 등산...쓰레기가 어마어마"	헤럴드POP
이시영, 볼륨감 넘치는 의상핏[포토엔HD]	뉴스엔
이시영, 집념의 관리하는 엄마..정상도 가뿐한 프로 등산러	헤럴드POP
등산의 매력에 빠진 스타들	VOGUE
이시영, 오늘도 아름다움이 한도초과…바람은 거들 뿐	헤럴드POP
이시영, 오늘은 청계산 정복..."날 너무 좋아, 한참 앉아서 멍♥"	스포츠조선
이시영, 으리으리한 대저택 거실 공개..'럭셔리+화이트' 깔끔 그 자체	스포츠조선
이시영, 불곡산 등산 추천.."볼거리 많아요"	스타뉴스
이시영, 바지에 휴지 낀 채 화장실 나와?…'틱톡' 영상 공개	마이데일리
이시영, 3살 아들과 '커플 청바지+양말'→손 꼭 잡고 앙증맞은 워킹♥	헤럴드POP
이시영, 일상 속 느껴지는 여배우 포스…'청초한 미모'는 감탄	스포츠조선
이시영 뒤처리 엉망→꺠알 웃음, 특급 팬서비스	스포츠동아
[[김삼웅의 인물열전] 성재 이시영선생 평전] 피난수도에서 85세로 서거	오마이뉴스
이시영, 우아한 퇴근길에 빛이나··마스크 써도 예쁜 미모에 '눈길'	헤럴드POP
이시영, 가녀린 거울 셀카..눈만 보여도 벌써 예쁨 폭발	헤럴드POP
[포토]'블링크'의 이시영	헤럴드POP
이시영, 어깨 치솟은 의상도 찰떡 소화..역시 패완얼(ft.이유비X김지민)	헤럴드POP
[[김삼웅의 인물열전] 성재 이시영선생 평전] 서거할 때까지 대종교 참여	오마이뉴스
이시영, 하루도 빠짐없이 아침 등산 인증..관리의 여신 맞네	헤럴드POP
이시영, 걸크러시 패션도 찰떡소화 "가을여신의 나들이"	TV리포트
이시영, 가을 분위기 물씬..애엄마의 심쿵 눈맞춤	헤럴드POP
이시영, 등산도 하고 쓰레기도 줍고..본받아야 할 자제	헤럴드POP
이시영, 살짝 드러낸 잘록 개미허리..모델핏 시선강탈	헤럴드POP
이시영 '아들 맘'의 초롱초롱한 눈빛→짙은 쌍꺼풀이 매력적이야♥	헤럴드POP
[[김삼웅의 인물열전] 성재 이시영선생 평전] 떼밀려 대선후보에 나섰으나	오마이뉴스
이시영, 오늘은 등산복 말고 사복··화사한 퇴근길♥	헤럴드POP
이시영, 귀염뽀짝 아들과 커플룩..다정한 일상♥	헤럴드POP
이시영, 결혼 후 더 예뻐진 '여배우 포스'…아들맘의 '가을 패션'	스포츠조선
이시영, 마스크로 가릴 수 없는 여신美…비가 와도 미모는 맑음	헤럴드POP
[[김삼웅의 인물열전] 성재 이시영선생 평전] 부통령 자리 내던지다	오마이뉴스
이시영, 햄버거 티셔츠 입고 러블리 매력 "오랜만에 피티샵"	헤럴드POP
이시영, 갈수록 더 어려져..대학생 같은 청순+풋풋 매력	헤럴드POP
이시영x이유비x김지민, '셀럽뷰티'가 모였다..'핫'한 외모[★SHOT!]	OSEN
이시영, 아들과 초깜찍 ♥커플양말 인증…러블리 母子	스포츠조선
[MD포토] 이시영, '과감한 노출'	마이데일리
이시영 39세 맞아? 빛나는 청초+동안 미모[SNS★컷]	뉴스엔
[[김삼웅의 인물열전] 성재 이시영선생 평전] '살아 남은 자의 슬픔'	오마이뉴스
이시영, 라이더 자켓 입으니 가을 느낌 물씬..오늘은 '사복 요정'	헤럴드POP
'나는 살아있다' 김성령부터 오정연까지, 비장함 가득 메인 포스터 공개	엑스포츠뉴스
이시영, 민낯도 이렇게 예쁠 일?..청순함에 또 반했네	헤럴드POP
이시영, 등산 마니아→등산 전문 유튜버로? "내일 채널 오픈해요"	스포츠조선
"결혼기념일♥" 이시영, '사업가 남편'이 직접 만들어준 케이크에 감동 폭발	스포츠조선
'나는 살아있다' 박은하X김성령X이시영X김민경X오정연X김지연X우기 출연 확정...	OSEN
이시영, 가정집 밥상 맞아? 로브스터→전복까지 “아빠 솜씨” [SNS★컷]	뉴스엔
[N샷] 이시영, 럭셔리 하우스 속 거실 인테리어 공개…깔끔	뉴스1
혹독한 생존 도전기 ‘나는 살아있다’, 11월 5일 첫 방송 확정	데일리안
이시영, 사랑 듬뿍 받는 달달 결혼기념일..남편도 살짝 공개	헤럴드POP
[N샷] 이시영, 럭셔리 하우스 속 거실 인테리어 공개…깔끔	뉴스1
혹독한 생존 도전기 ‘나는 살아있다’, 11월 5일 첫 방송 확정	데일리안
팔 다친 이시영, 로브스터에 전복까지…으리으리 아빠 밥상으로 몸보신 [★해...	엑스포츠뉴스
'나는 살아있다', 피할 수 없다면 맞서라! 메인 포스터 비장함 가득	톱데일리
이시영, 사랑 듬뿍 받는 달달 결혼기념일..남편도 살짝 공개	헤럴드POP
'결혼 3주년' 이시영, 남편이 직접 만들어준 케이크에 '감동'	enews24
이시영, 유튜브 채널 오픈.."등산 다니면서 즐겁게 열심히 촬영했어요"	헤럴드POP
이시영 "돈주고 살수없는 북한산 힐링..가슴이 뻥~"	일간스포츠
'나는 살아있다' 김성령→우기, 캐릭터 티저 공개 "살고 싶으면 배워라"	싱글리스트
이시영, 워킹맘의 화려한 외출..동안 미모 자체발광	헤럴드POP
이시영, 워킹맘의 화려한 외출..동안 미모 자체발광	헤럴드POP
이시영, 동안 미모 종결자..수수해도 너무 예뻐	헤럴드POP
배우 이시영, 아무것도 안 하고 21억 번 비법 [집코노미TV]	한국경제언론사 선정
[오마이포토] 'SF8' 이시영, 변치않는 건강	오마이뉴스
이시영, 럭셔리 화이트톤 거실 공개..."어디에 놓아야 예쁘지"	매일경제
이시영, 일상이 화보…가을 느낌 물씬나는 '패션의 완성'	스포츠조선
배우 이시영 "한없이 사랑해" 애정을 담은 케이크 공개	아시아뉴스통신
'나는 살아있다' 3분 생존 티저 공개 "재난은 예고 없이 찾아온다"	스포츠한국
[포토] 건강미 넘치는 이시영	매일경제
'나는 살아있다' 박은하→우기, 첫 티저 영상 속 생존 도전기..11월 5일 첫방	헤럴드POP
김성령·이시영·김민경, 생존 전사 프로젝트 '나는 살아있다' 출연 확정(공식...	YTN
이시영, ♥조승현 대표와 결혼 3주년 자축 "케이크 만들어줘서 행복♥" [★SH...	OSEN
이시영, 대리석 식탁→드넓은 거실 '으리으리' 집 공개 [★SHOT!]	OSEN
이시영 '아름다운 미소'[엑's HD포토]	엑스포츠뉴스
[포토] 형사로 무대 오르는 이시영	매일경제
이시영, 럭셔리 거실 공개 "아이 있는 집? 다른 곳들은…" [★해시태그]	엑스포츠뉴스
"애 엄마 맞아?"..이시영, 걷는 곳이 어디든 런웨이…대학생이래도 믿을 비주...	헤럴드POP
이시영, 야외에서 마스크 벗고 셀카..더 예뻐졌네	헤럴드POP
이시영, 키즈카페 아냐?…널찍한 아들 방 사진에 오윤아도 "부럽다"	스포츠조선
"돈 주고도 못사는 힐링" 이시영, 아무도 없는 북한산 오른 '자기관리의 神'	스포츠조선
이시영, 야외에서 마스크 벗고 셀카..더 예뻐졌네	헤럴드POP
이시영, 키즈카페 아냐?…널찍한 아들 방 사진에 오윤아도 "부럽다"	스포츠조선
"돈 주고도 못사는 힐링" 이시영, 아무도 없는 북한산 오른 '자기관리의 神'	스포츠조선
이시영, 가을 느낌 물씬...`사복 여신`	매일경제
이시영 "다이어트로 시작한 등산...쓰레기가 어마어마"	헤럴드POP
이시영-한가람-하준 '반가워요'[엑's HD포토]	엑스포츠뉴스
이시영, 볼륨감 넘치는 의상핏[포토엔HD]	뉴스엔
등산의 매력에 빠진 스타들	VOGUE
‘나는 살아있다’ 김성령→우기까지, 특전사 중사 출신 교관과 재난 상황에 ...	스포츠경향
이시영, 집념의 관리하는 엄마..정상도 가뿐한 프로 등산러	헤럴드POP
이시영, 오늘도 아름다움이 한도초과…바람은 거들 뿐	헤럴드POP
이시영, 오늘은 청계산 정복..."날 너무 좋아, 한참 앉아서 멍♥"	스포츠조선
이시영, 으리으리한 대저택 거실 공개..'럭셔리+화이트' 깔끔 그 자체	스포츠조선
"아이 있는 집 맞아?"…이시영, 럭셔리 하우스+깔끔 거실에 네티즌 '깜짝'	마이데일리
이시영, ‘블링크’ 여주인공으로 인사[포토엔HD]	뉴스엔
이시영, 불곡산 등산 추천.."볼거리 많아요"	스타뉴스
이시영, 바지에 휴지 낀 채 화장실 나와?…'틱톡' 영상 공개	마이데일리
이시영, 북한산 백운대 위 홀로..절경이 따로 없네 "가슴이 뻥"	헤럴드POP
이시영, 3살 아들과 '커플 청바지+양말'→손 꼭 잡고 앙증맞은 워킹♥	헤럴드POP
이시영, 일상 속 느껴지는 여배우 포스…'청초한 미모'는 감탄	스포츠조선
이시영의 ‘스위트 홈’은 어떨까?…‘화이트톤+럭셔리+깔끔’ 3박자 갖춘 집	세계일보
이시영, 바지에 휴지 낀 채 화장실 나와?…'틱톡' 영상 공개	마이데일리
이시영, 북한산 백운대 위 홀로..절경이 따로 없네 "가슴이 뻥"	헤럴드POP
이시영, 3살 아들과 '커플 청바지+양말'→손 꼭 잡고 앙증맞은 워킹♥	헤럴드POP
이시영, 일상 속 느껴지는 여배우 포스…'청초한 미모'는 감탄	스포츠조선
이시영, 프로 등산러의 기분 좋은 에너지 "불곡산 진짜 멋진 산"	헤럴드POP
이시영 뒤처리 엉망→꺠알 웃음, 특급 팬서비스	스포츠동아
[[김삼웅의 인물열전] 성재 이시영선생 평전] 피난수도에서 85세로 서거	오마이뉴스
이시영, 목폴라 티셔츠에 명품백 포인트…럭셔리한 '가을 패션' 완성	스포츠조선
이시영, 우아한 퇴근길에 빛이나··마스크 써도 예쁜 미모에 '눈길'	헤럴드POP
이시영, 우아한 퇴근길에 빛이나··마스크 써도 예쁜 미모에 '눈길'	헤럴드POP
프로등산러 이시영, 산 정상서 유튜브 채널 오픈 예고[SNS★컷]	뉴스엔
이시영 "북한산서 돈주고 살수없는 힐링..가슴이 뻥"	enews24
이시영, 가녀린 거울 셀카..눈만 보여도 벌써 예쁨 폭발	헤럴드POP
"홈, 스위트 홈"..이시영, 럭셔리한 집 거실 공개	스타뉴스
[포토]'블링크'의 이시영	헤럴드POP
이시영, 어깨 치솟은 의상도 찰떡 소화..역시 패완얼(ft.이유비X김지민)	헤럴드POP
[[김삼웅의 인물열전] 성재 이시영선생 평전] 서거할 때까지 대종교 참여	오마이뉴스
“불곡산 진짜 멋져” 이시영, 이쯤되면 등산여신[SNS★컷]	뉴스엔
이시영, 하루도 빠짐없이 아침 등산 인증..관리의 여신 맞네	헤럴드POP
이시영, 하루도 빠짐없이 아침 등산 인증..관리의 여신 맞네	헤럴드POP
이시영, 키즈카페 뺨치는 '럭셔리' 아들방 공개 "넌 좋겠다"	스타뉴스
이시영 "등산 중 쓰레기 어마어마..플로깅 몸소 실천X추천"	enews24
이시영, 걸크러시 패션도 찰떡소화 "가을여신의 나들이"	TV리포트
tvN 측 "김성령·이시영·김민경 `나는 살아있다` 출연, 생존 전사 양성 프로...	매일경제
이시영, 가을 분위기 물씬..애엄마의 심쿵 눈맞춤	헤럴드POP
이시영, 등산도 하고 쓰레기도 줍고..본받아야 할 자제	헤럴드POP
이시영, 오늘은 청계산 등반→'등산 요정'의 청량한 비주얼♥	헤럴드POP
이시영, 살짝 드러낸 잘록 개미허리..모델핏 시선강탈	헤럴드POP
이시영 '아들 맘'의 초롱초롱한 눈빛→짙은 쌍꺼풀이 매력적이야♥	헤럴드POP
이시영 '아들 맘'의 초롱초롱한 눈빛→짙은 쌍꺼풀이 매력적이야♥	헤럴드POP
[[김삼웅의 인물열전] 성재 이시영선생 평전] 떼밀려 대선후보에 나섰으나	오마이뉴스
이시영, 오늘은 등산복 말고 사복··화사한 퇴근길♥	헤럴드POP
이시영, 귀염뽀짝 아들과 커플룩..다정한 일상♥	헤럴드POP
이시영, 결혼 후 더 예뻐진 '여배우 포스'…아들맘의 '가을 패션'	스포츠조선
이시영, 마스크로 가릴 수 없는 여신美…비가 와도 미모는 맑음	헤럴드POP
tvN 측 "김성령·김민경·이시영, 박은하 교관과 '나는 살아있다' 출격" [공식...	한국일보
이시영이 또! 북한산 백운대서 뽐낸 '완벽' 뒤태 [★SHOT!]	OSEN
[[김삼웅의 인물열전] 성재 이시영선생 평전] 부통령 자리 내던지다	오마이뉴스
이시영, 햄버거 티셔츠 입고 러블리 매력 "오랜만에 피티샵"	헤럴드POP
이시영, 무더위 속 북한산 등산 "돈 주고도 살 수 없는 힐링♥" [★해시태그]	엑스포츠뉴스
이시영, 햄버거 티셔츠 입고 러블리 매력 "오랜만에 피티샵"	헤럴드POP
이시영, 갈수록 더 어려져..대학생 같은 청순+풋풋 매력	헤럴드POP
이시영x이유비x김지민, '셀럽뷰티'가 모였다..'핫'한 외모[★SHOT!]	OSEN
이시영, 아들과 초깜찍 ♥커플양말 인증…러블리 母子	스포츠조선
이시영, 등산 요정의 사복 패션에 눈길··언제봐도 예뻐♥	헤럴드POP
[MD포토] 이시영, '과감한 노출'	마이데일리
이시영, 모델 하우스 같은 ‘초호화 럭셔리’ 아들방 “넌 좋겠다”	뉴스엔
이시영 39세 맞아? 빛나는 청초+동안 미모[SNS★컷]	뉴스엔
이시영, 착한 운동 ‘플로깅’ 실천 “생각보다 쓰레기 많아 놀라” [SNS★컷...	뉴스엔
이시영, 키즈카페 안 부러운 럭셔리 아들방 공개 "힐링공간, 넌 좋겠다"	마이데일리
[[김삼웅의 인물열전] 성재 이시영선생 평전] '살아 남은 자의 슬픔'	오마이뉴스
완벽 비율 이시영, 출근길 패셔니스타 [SNS★컷]	뉴스엔
이시영, '오징어튀김' 가방→아들과 커플룩까지…"패션의 완성은 미모"	스포츠조선
이시영, 출산 후 '더 물오른 미모'…'긴 생머리 여신'	스포츠조선
[오마이포토] 'SF8' 이시영, 건강미 국가대표	오마이뉴스
이시영, 청순미 뽐내며 또 운동 다짐..."다시 시작"	매일경제
[N샷] 소유진, 이시영과 관악산 등산 "고맙다 건강한 친구야"	뉴스1
'나는 살아있다' 오정연부터 우기까지, 혹독한 생존 나선다	한국경제
[[김삼웅의 인물열전] 성재 이시영선생 평전] 분단정부에 참여하기로 결단	오마이뉴스
[[김삼웅의 인물열전] 성재 이시영선생 평전] 분단정부에 참여하기로 결단	오마이뉴스
'셀럽뷰티2' 이시영, 혜린 새벽형 인간을 위한 ‘얼리버드 케어’...두 배 이...	환경미디어
이시영, 30개월 볼살 통통 귀요미 아들과 데이트 "벌써부터 바다걱정"	스포츠조선
이시영, 프로등산러의 일상…늘씬 뒤태에 '시선 강탈' [★해시태그]	엑스포츠뉴스
[[김삼웅의 인물열전] 성재 이시영선생 평전] 반민특위 해체와 6ㆍ25전쟁 와중...	오마이뉴스
tvN 측 “김성령 이시영 김민경 ‘나는 살아있다’ 출연, 생존 전사 도전”(공...	뉴스엔
이시영, 잔디 깔린 럭셔리 옥상서 수영장 만드는 ♥남편+아들과 행복한 일상	스포츠조선
이시영, 키즈카페 뺨치는 아들 방 공개..잔디 깔린 럭셔리 테라스까지	스포츠조선
[MD포토] 이시영, '우아한 표정으로'	마이데일리
이시영, 올블랙 시크美..부러질 것 같은 각선미	헤럴드POP
[MD포토] 이시영, '기분 좋은 미소'	마이데일리
이시영, 올블랙 시크美..부러질 것 같은 각선미	헤럴드POP
[[김삼웅의 인물열전] 성재 이시영선생 평전] 이승만의 독선적인 조각에 반기	오마이뉴스
이시영, 이영표X션과 함께한 주말 일상 "한강 달리기 10km"	일간스포츠
[[김삼웅의 인물열전] 성재 이시영선생 평전] 고뇌의 심경담은 '시위소찬'의 ...	오마이뉴스
[[김삼웅의 인물열전] 성재 이시영선생 평전] '하는일 없이 세금먹는 자리 떠...	오마이뉴스
이시영, 프로등산러의 건강한 에너지 '청초미 뿜뿜'	헤럴드POP
이시영, 으리으리한 옥상 수영장 인증..남편+아들과 행복	헤럴드POP
이시영, 체지방 9.8% 위엄...절친 소유진과 아침 산행 인증	스포츠조선
[[김삼웅의 인물열전] 성재 이시영선생 평전] 언론 통해 '부통령설' 처음 듣고	오마이뉴스
이시영, 프로등산러의 건강한 에너지 '청초미 뿜뿜'	헤럴드POP
이시영, 으리으리한 옥상 수영장 인증..남편+아들과 행복	헤럴드POP
이시영, 체지방 9.8% 위엄...절친 소유진과 아침 산행 인증	스포츠조선
[[김삼웅의 인물열전] 성재 이시영선생 평전] 언론 통해 '부통령설' 처음 듣고	오마이뉴스
이시영, 대학생이라 해도 믿을 ‘동안 미모’‥애엄마 맞아?[SNS★컷]	뉴스엔
[[김삼웅의 인물열전] 성재 이시영선생 평전] 임정의 마지막 국무위원	오마이뉴스
이시영, 마스크 쓰고 데일리룩 자랑…수수해도 빛나는 자태	헤럴드POP
[[김삼웅의 인물열전] 성재 이시영선생 평전] 국회, 사임서 반려했지만 초지관...	오마이뉴스
[포토]이시영, '오랜만에 인사드려요'	일간스포츠
이시영, 멋짐 뚝뚝 일상	한국일보
이시영, 짙은 쌍꺼풀에 푹 빠지겠어··눈만 봐도 예쁨이 넘쳐흘러	헤럴드POP
[[김삼웅의 인물열전] 성재 이시영선생 평전] 해방공간에 신흥대학 세웠지만	오마이뉴스
이시영, 감탄사부르는 옥상 수영장 클래스	enews24
이시영 “이렇게 물 많은 청계산 계곡 처음” 아침부터 등산 삼매경 [SNS★컷...	뉴스엔
이시영, 알록달록 인테리어 대박 거실 공개 "어디에 놓아야 예쁜가.."	헤럴드POP
이시영 아들, 엄마 독특 가방에 "오징어튀김이야?" 폭소	헤럴드POP
[MD포토] 이시영, '형사역에 딱이에요'	마이데일리
이시영, 럭셔리한 아들 방 공개…"넌 좋겠다"	머니투데이
[포토]이시영, 빛나는 미소	헤럴드POP
이시영, 이 언니 산에서 또 화보 찍네..프로 등산러의 건강한 일상	헤럴드POP
이시영, 완벽한 팔굽혀펴기 자세→'성난 등근육+식스팩 복근'…감탄이 절로[종...	스포츠조선
[[김삼웅의 인물열전] 성재 이시영선생 평전] '책략가 대통령 곁에 선 선비 부...	오마이뉴스
이시영, '육아 탈출 근황'…마스크로도 가릴 수 없는 '배우 포스'	스포츠조선
이시영, 30개월 잘생긴 아들 공개..통통 양 볼이 귀여워	헤럴드POP
[포토]미소 짓는 이시영	이데일리
[[김삼웅의 인물열전] 성재 이시영선생 평전] 황염배가 왜곡한 조선역사	오마이뉴스
이시영, 다리 길어보이는 패션..올블랙룩에 핫핑크 포인트	헤럴드POP
이시영, 바위 절벽에서 '탄탄한 각선미'…'불암산'과 ♥에 빠진 여신	스포츠조선
이시영, 대학생이래도 믿을 동안 미모 ‘예쁘다 예뻐’[SNS★컷]	뉴스엔
이시영, 마스크 벗고 티없이 맑은 비주얼..몸매가 다했네	헤럴드POP
이시영, 우아한 청순 비주얼…빛나는 퇴근길 [리포트:컷]	TV리포트
이시영, 한 발 앞서간 가을 패션…센스 폭발한 '우월한 미모'	스포츠조선
이시영, 마스크로도 가릴 수 없는 '배우 포스'…169cm '황금 비율 몸매는 덤'	스포츠조선
이시영, 마스크 써도 숨길 수 없는 여신 미모…일상이 화보 [SNS★컷]	뉴스엔
이시영, 이번에는 검단산 정복…"추천 감사, 덕분에 1kg은 족히 빼고 와"	스포츠조선
[[김삼웅의 인물열전] 성재 이시영선생 평전] 다시 의정원 의원으로 선출되고	오마이뉴스
이시영, 등산 중 미모 열일…주변 밝히는 환한 미소	헤럴드POP
[MD포토] 이시영, '형사역할 잘 어울리나요?'	마이데일리
박수치는 이시영	뉴스1
이시영 '건강한 미소'	뉴스1
이시영 '건강한 미소'	뉴스1
이시영, 수수해도 여신美 한가득..애엄마의 예쁨 클래스	헤럴드POP
이시영, 아들과 귀여운 커플양말…사랑스러운 母子	헤럴드POP
이시영, 이번엔 가을 청계산..프로등산러의 미모	헤럴드POP
이시영, 등산 요정의 수락산 등반··뒷모습도 행복해 보여♥	헤럴드POP
이시영, 애 엄마 맞아?…10등신 피지컬+출산 후 '더 예뻐진 미모'	스포츠조선
[[김삼웅의 인물열전] 성재 이시영선생 평전] 임정 헌법기초위원으로 활약	오마이뉴스
KBS Joy '셀럽뷰티2' 이시영, '시봉 마사지기' 리뷰	데일리그리드
이시영, 니트+청바지로 가을 분위기 물씬…청초미 가득 일상 [★해시태그]	엑스포츠뉴스
‘셀링데이 마스크팩’ 셀럽뷰티2 이시영의 홈케어 마스크팩으로 소개	환경미디어
"넌 좋겠다" 이시영, 키즈카페 뺨치는 3살 아들 방…오윤아 "부럽다"	스포티비뉴스
이시영, 수수해도 자체발광 미모..청순미가 뚝뚝	헤럴드POP
이시영, 펜싱 국대 동생에겐 너무 쉬웠던 등산 “미안해, 다음엔 도봉산 가자...	뉴스엔
[[김삼웅의 인물열전] 성재 이시영선생 평전] 고종의 해외망명 준비했으나	오마이뉴스
이시영, 오후 밝히는 러블리 미모…아들과 청청 커플룩 [★해시태그]	엑스포츠뉴스
이시영, 벌써 자켓 입는 패셔니스타‥애엄마의 예쁨 클라스	헤럴드POP
이시영, 오늘도 세련된 데일리룩…청순함 넘치는 미모	헤럴드POP
이시영, 오늘도 산 정복♥..아름다운 운동복 여신	헤럴드POP
이시영, 성난 근육 자랑하는 팔굽혀펴기[SNS★컷]	뉴스엔
이시영, 빛나는 결혼 반지+아들이 골라준 반지 끼고 '여유로운 주말'	스포츠조선
이시영, 선명한 등근육+복근 인증..팔굽혀펴기 장인 면모	스타뉴스
[[김삼웅의 인물열전] 성재 이시영선생 평전] 해방정국, 임시정부 국무위원으...	오마이뉴스
[[김삼웅의 인물열전] 성재 이시영선생 평전] 중국에 우정어린 질책과 황염배...	오마이뉴스
이시영X주원, `근육질 팔뚝`으로 휴대폰 하는 운동메이트	매일경제
이시영, 마스크로 못 가린 미모 ‘눈만 보여도 예뻐’[SNS★컷]	뉴스엔
[[김삼웅의 인물열전] 성재 이시영선생 평전] 역사왜곡에 대응한 역사평론 집...	오마이뉴스
[포토]이시영, '미모는 여전해'	일간스포츠
[[김삼웅의 인물열전] 성재 이시영선생 평전] 평남 관찰사로 민정 살펴	오마이뉴스
이시영, 얼굴 가득 아름다움 철철…갈수록 예뻐지는 비결이 뭐야	헤럴드POP
이시영, 꽃이야 사람이야? 마스크로 못 가리는 민낯 미모 [★SHOT!]	OSEN
이시영, 눈웃음에 사르르 녹겠네..세련미 폭발하는 일상	헤럴드POP
‘나는 살아있다’ 김민경, 김성령×이시영 등과 재난 상황 생존 도전	스포츠경향
이시영, 럭셔리 아들 방 공개..잔디 깔린 테라스 눈길	스타뉴스
[[김삼웅의 인물열전] 성재 이시영선생 평전] 교섭국장 맡아 고군분투	오마이뉴스
이시영, 이렇게 예쁜 애엄마 봤어? 탄탄한 각선미도 감탄	헤럴드POP
[[김삼웅의 인물열전] 성재 이시영선생 평전] 총독부의 매수공작과 '개벽'지 ...	오마이뉴스
이시영 '그림자도 아름다워'	뉴스1
생각에 잠긴 이시영	뉴스1
[[김삼웅의 인물열전] 성재 이시영선생 평전] 중국인 창고 빌어 민족교육	오마이뉴스
이시영, 대학생 뺨치는 패션 센스…동안 미모는 덤 [SNS★컷]	뉴스엔
"애엄마 맞아?" 이시영, 일상도 화보가 되는 순간 [★SHOT!]	OSEN
이시영, 잔디 깔린 옥상+럭셔리 수영장 공개…행복한 일상 [★해시태그]	엑스포츠뉴스
[포토]이시영, 오랜만에 돌아왔습니다	이데일리
이시영, 청청패션도 잘 어울려…패셔니스타다운 센스	헤럴드POP
[[김삼웅의 인물열전] 성재 이시영선생 평전] 형과 함께 신민회 등 구국운동	오마이뉴스
'SF8-블링크' 이시영 "난 아직 내 감 믿고 아날로그 애착가는편"	스포츠조선
이시영, 시선 사로잡는 청순 미모… 귀요미 아들과 커플룩[SNS★컷]	뉴스엔
이시영, 투명우산 쓴 청순 여신..수수해서 더 예뻐	헤럴드POP
sf8 '블링크' 한가람 감독, "이시영과 함께여서 다양한 액션 가능했다"	MBC연예
[[김삼웅의 인물열전] 성재 이시영선생 평전] 민단자치기관으로 경학사 설립	오마이뉴스
이시영, 테라스 잔디밭+간이 수영장 ‘럭셔리 자택 공개’ [SNS★컷]	뉴스엔
[[김삼웅의 인물열전] 성재 이시영선생 평전] '만주의 무관제왕' 일본신문 보...	오마이뉴스
이시영, 아들과 커플 양말…패셔니스타 母子 [★해시태그]	엑스포츠뉴스
이시영, 흑백 뚫고 나오는 걸크러시…만능 운동러의 건강미	헤럴드POP
"넌 좋겠다" 이시영, 아들 방에 키즈카페 차린 줄..'고급' 원목 인테리어 자랑...	OSEN
이시영, 벌써 가을여신 등극…파워숄더 재킷도 찰떡소화	헤럴드POP
이시영, 여전히 상큼 발랄한 미모..대학생인 줄	헤럴드POP
[[김삼웅의 인물열전] 성재 이시영선생 평전] 상하이 임시정부 법무총장에 선...	오마이뉴스
[[김삼웅의 인물열전] 성재 이시영선생 평전] 삼원보 추가가마을에 도착했으나	오마이뉴스
이시영, 핫팬츠 입고 뽐낸 늘씬 각선미	매일경제
이시영, 대학생 연상하게 하는 비주얼 ‘애엄마 맞아?’ [SNS★컷]	뉴스엔
이시영, 반바지로 드러난 11자 각선미…소유진 "예쁜 시영이♥"	스포츠조선
[[김삼웅의 인물열전] 성재 이시영선생 평전] 신흥무관학교 창설, 교장 맡아 ...	오마이뉴스
이시영, 반바지로 뽐낸 탄탄한 각선미 ‘건강미는 덤’ [SNS★컷]	뉴스엔
이시영, 워킹맘의 화려한 외출..세련미 철철 미모 셀카	헤럴드POP
[[김삼웅의 인물열전] 성재 이시영선생 평전] 다시 임시정부 살림살이 맡는 재...	오마이뉴스
[[김삼웅의 인물열전] 성재 이시영선생 평전] 한성정부 재무총장 이어 상하이...	오마이뉴스
이시영, 파란색 점프 슈트 찰떡 소화…멋짐 뚝뚝 흐르는 자태	헤럴드POP
이시영, 쌀국수 폭풍 흡입 중 웃음 빵.."먹을 땐 찍지마"	헤럴드POP
[[김삼웅의 인물열전] 성재 이시영선생 평전] '을사늑약' 저지에 노력했으나	오마이뉴스
[[김삼웅의 인물열전] 성재 이시영선생 평전] 중국총통 위안스카이 만나 지원...	오마이뉴스
[포토] 이시영, '긴장했어요~'	한국경제
이시영 각선미가…이번엔 근육美 아닌 우아美	매일경제
이시영, 초복 더위 날리는 미모…청량美 대방출 [★해시태그]	엑스포츠뉴스
[[김삼웅의 인물열전] 성재 이시영선생 평전] 관직에서 물러나 법률학 공부	오마이뉴스
이시영, 싱그러움 한가득 무공해 비주얼… 모든 순간 심쿵 모먼트	헤럴드POP
이시영, 수수한 일상도 엄지척..작은 얼굴 속 꽉 찬 이목구비	헤럴드POP
이시영, 러블리 원피스 입고 ‘탄탄 건강美’	매일경제
[인터뷰] 이시영X하준 시네마틱드라마 <블링크>, 감독이 전한 현장 비하인드	여성조선
이시영, 민낯에도 자체발광 미모..시선강탈 美친 예쁨	헤럴드POP
이시영, 이번엔 수락산이다…'1일 1등산'하는 프로등산러 등극	스포츠조선
이시영, 사복 입은 반전매력 여신..운동복과는 다른 반전매력	헤럴드POP
"명불허전 동안미녀" 이시영, 꾸안꾸 패션도 '청순美' 샤랄라 [★SHOT!]	OSEN
이시영, 가슴 강조한 파격 블라우스…청순 글래머의 정석	스포츠조선
이시영, 귀요미 아들 정윤과 청청 커플룩 완성 '행복한 일상' [★SHOT!]	OSEN
이시영, 급경사 바위도 거뜬한 '프로등산러'…'100대 명산' 곧 정복할 기세	스포츠조선
[[김삼웅의 인물열전] 성재 이시영선생 평전] 윤봉길의거 뒤 피신했다가 임시...	오마이뉴스
이시영, 오늘도 싱그러운 비주얼…심쿵부르는 아름다운 자태	헤럴드POP
이시영, 귀요미 아들과 주말데이트 ‘행복한 일상’[SNS★컷]	뉴스엔
이시영, 혜린과 함께 여신美 뿜뿜..자체발광 꽃미모	헤럴드POP
이시영, 프로등산러의 슬픈 사연 "입산 금지로 그냥 돌아온.."	헤럴드POP
이시영, 손바닥 크기의 명품백 착용하고 셀카..독특하네	헤럴드POP
이시영, 펜션 연상케 하는 아들 방 공개 ‘잔디밭 테라스도’ [SNS★컷]	뉴스엔
이시영, 주말 맞아 도봉산 등산..신선대 정상서 화보같은 뒤태 [★SHOT!]	OSEN
이시영, 시크미 넘치는 데일리룩…머리만 넘겨도 화보	헤럴드POP
[[김삼웅의 인물열전] 성재 이시영선생 평전] 대한제국 일제에 병탄되는 아픔...	오마이뉴스
이시영 부부 건물 시세 차익 40억원 안긴 이는 김성근 전 감독	스포츠경향
이시영, 이 비율 실화냐...걸그룹 1도 안 부러운 미모	매일경제
이시영, 꽃 향기 맡는 모습도 아름다워…"오늘은 싱그러운 여신"	스포츠조선
이시영, 흐린 날에도 미모는 그대로…청순 옆태 '심쿵' [★해시태그]	엑스포츠뉴스
[E포토] 이시영, '빛나는 미모'	SBS funE
이시영, 귀요미 아들과 주말 나들이…아가씨 같은 미모 [★해시태그]	엑스포츠뉴스
이시영, 청순美 넘치는 미모...'예쁨 한도 초과'	뉴스컬처
이시영, 시골 친정에서 직접 감자 캐는 미녀 엄마	헤럴드POP
[[김삼웅의 인물열전] 성재 이시영선생 평전] 김홍집의 딸과 초혼, 10여년 뒤...	오마이뉴스
이시영, 불암산과 사랑에 빠진 여신 ‘탄탄한 각선미’ [SNS★컷]	뉴스엔
[[김삼웅의 인물열전] 성재 이시영선생 평전] 신흥학우단으로 정신 이어져	오마이뉴스
이시영, 일상이 화보..우월한 기럭지+패션 소화력 甲	스타뉴스
이시영, 럭셔리 옥상 수영장 공개…남편+아들과 행복한 시간 [스타★샷]	스포츠월드
이시영, 169cm 장신의 완벽 비율…화려한 변신 [★해시태그]	엑스포츠뉴스
[[김삼웅의 인물열전] 성재 이시영선생 평전] 15세에 과거 급제, 순탄한 출세...	오마이뉴스
이시영 "갑자기 허리 아파..디스크 눌리면 이런 건가요, 너무 우울"	헤럴드POP
이시영, '체지방 9.8%' 인증 뒤태…등산으로 다져진 '탄탄+늘씬' 몸매	스포츠조선
[[김삼웅의 인물열전] 성재 이시영선생 평전] 삼한갑족에서 금수저 물고 태어...	오마이뉴스
이시영, 쌀국수 먹방도 청순…"먹을 땐 찍지 마" [★해시태그]	엑스포츠뉴스
[포토] 이시영, '이 구역 분위기 여신'	한국경제
이시영, 긴 생머리+아련한 눈빛…청순함의 교과서	스포츠조선
이시영, 건강한 일상 비결은 등산?…"불암산 사랑하게 됐어" [★해시태그]	엑스포츠뉴스
이시영, 숨길 수 없는 미모…독보적 패션 센스는 덤 [★해시태그]	엑스포츠뉴스
이시영 아들 정윤이, 엄마 닮은 선명한 이목구비 '눈길' [★SHOT!]	OSEN
이시영 아들 정윤이, 엄마 닮은 선명한 이목구비 '눈길' [★SHOT!]	OSEN
이시영, 딱 봐도 대학생 비주얼 ‘하이웨스트도 완벽 소화’ [SNS★컷]	뉴스엔
이시영, 비 오는 새벽에도 등산 포기 못해…'등산♥'=건강 몸매의 비결	스포츠조선
이시영·하준 'SF8-블링크', 오늘(4일) 공개...SF 수사물의 모든 것	한국일보
이시영, 허리가 어디 있는거야…169cm 장신의 끝없는 다리 길이	스포티비뉴스
[E포토] 이시영, '건강미 넘치는 미소'	SBS funE
이시영, 마스크로도 안가려지는 청순미모 [리포트:컷]	TV리포트
이시영, 마네킹 아니야?…일상 속 빛나는 9등신 마네킹 비율	스포츠조선
[[김삼웅의 인물열전] 성재 이시영선생 평전] 고종의 '관전사'로 청일전쟁 현...	오마이뉴스
[N샷] 이시영, 키즈카페 부럽지 않은 아이방 공개…깔끔 인테리어	뉴스1
[포토]이시영, 우아하게!	스포츠서울
이시영, 30개월 아들과 데이트…귀여운 볼+또렷 이목구비=앙증 그 자체 [★해...	엑스포츠뉴스
이시영, 어마어마한 바위 들어올리며…복서 출신 다운 '파워'	스포츠조선
이시영, 민낯 맞아? 팬심 사로잡는 달걀형 얼굴[SNS★컷]	뉴스엔
이시영, 민낯도 청초하니 예쁘네..명품 티셔츠 입고 외출	헤럴드POP
[포토]이시영-한가람-하준, '오붓하게'	일간스포츠
이시영, 도봉산 등반 인증샷…안개도 못 막은 '등산 사랑♥'	스포츠조선
이시영, 꽃보다 예쁜 청순 민낯..자체발광 비주얼	헤럴드POP
이시영, 군살 하나 없는 탄탄 복근 '일상이 화보'	스타뉴스
이시영, 흐린 날씨에도 미모는 맑음…청순美 대방출 [★해시태그]	엑스포츠뉴스
이시영, 흐린 날씨에도 미모는 맑음…청순美 대방출 [★해시태그]	엑스포츠뉴스
이시영, 운동복 입은 여신..땀흘려도 예쁘네	헤럴드POP
이시영, 대학생으로 착각할 비주얼 ‘수수해도 아름다워’ [SNS★컷]	뉴스엔
이시영, 건강미란 이런 것 ‘탄탄 각선미+밝은 미소’ [SNS★컷]	뉴스엔
이시영, 사패산도 접수…청순 등산 마니아 "너무 예쁜 곳" [★해시태그]	엑스포츠뉴스
인사말하는 이시영	뉴스핌
이시영 '우아한 워킹'	뉴스핌
이시영, 서 있는 곳 런웨이 만드는 비율 ‘소멸직전 소두’[SNS★컷]	뉴스엔
이시영, 김구라·솔비·설민석과 럭셔리 집서 화려한 만찬 [★해시태그]	엑스포츠뉴스
이시영, 반바지로 뽐낸 건강미…소유진 "예쁜 시영이"	아시아경제
[성재 이시영선생 평전] 임정측과 결별, 김구와 갈라선 배경	오마이뉴스
이시영-한가람 감독-하준 ‘블링크’로 만났어요[포토엔HD]	뉴스엔
'셀럽뷰티 시즌2' 첫방서 이시영, 혜린 '드래곤시카 크림' 소개	일간스포츠
이시영, 과즙美 뿜뿜 일상…존재 자체가 사랑스러워 [★해시태그]	엑스포츠뉴스
이시영, 물오른 미모에 팬들 '심쿵'	뉴스컬처
셀럽뷰티2 이시영의 잇템으로 '셀링데이 마스크팩' 소개	시사매거진
이시영, 비 오는 날도 등산요정..우월한 레깅스 핏은 덤이야	헤럴드POP
[[김삼웅의 인물열전] 성재 이시영선생 평전] 의정원, 이승만 대통령 탄핵	오마이뉴스
이시영, 검단산도 정복 완료 "1kg는 족히 빠져…산 제보 받아요" [★해시태그...	엑스포츠뉴스
이시영, 멜빵바지+마스크 조합… 러블리 매력 뿜뿜 "오늘은 대청소의 날"	스포츠조선
이시영, 굴욕無 민낯+러블리 미소…'여신 그 자체' [★해시태그]	엑스포츠뉴스
"출산한 몸매 맞아?" 이시영, 배꼽 빼꼼해도 '굴욕無' 여신자태 [★SHOT!]	OSEN
이시영, 일상 속에서도 걷기 운동…긴 생머리로 '청순미 물씬'	스포츠조선
이시영, 사패산도 접수… 역시 등산 마니아다운 포스 [SNS★컷]	뉴스엔
이시영, 럭셔리 하우스 속 아들 방 인테리어 공개…잔디 마당까지 '깜짝'[★해...	엑스포츠뉴스
이시영 "100대 명산에 도전합니다"..본격 산악인 인증샷	헤럴드POP
셀럽뷰티2 이시영, 혜린 슬기로운 집콕생활에 닥터바르미 베개, 방석 공개	뉴스프리존
이시영, 앉아만 있어도 화보…분위기 여신 등극	헤럴드POP
이시영X주원 운동메이트라 닮았나…셀프 폭소	스포츠동아
이시영, 패셔니스타란 이런 것…우아美 넘치는 하의실종룩	헤럴드POP
'나는 살아있다' 김민경, 김성령X이시영 이어 합류 "생존전략 팁 전한다" [공...	마이데일리
이시영, 허리디스크 고통 호소…"삶의 질 떨어져 우울해" [★해시태그]	엑스포츠뉴스
[[김삼웅의 인물열전] 성재 이시영선생 평전] 지도자들의 헌신에 학도들 의기...	오마이뉴스
김수로, 이시영의 응원차 연극 관람에 뭉클 "의리녀..감사한 하루"	헤럴드POP
이시영, 더위 날리는 시스루 셔츠…막 찍어도 멋짐 [★해시태그]	엑스포츠뉴스
이시영, 흰티에 청바지만 입어도 이정도…감탄 자아내는 데일리룩	헤럴드POP
[포토] 이시영, 형사 지우 역 맡았습니다	MBC연예
이시영, 마스크는 필수... 가려도 빛나는 수수한 미모 [★해시태그]	엑스포츠뉴스
이시영, 운동복 여신의 반전매력..여신이 여기 있네	헤럴드POP
[TV 엿보기] SF8 ‘블링크’ 감독 “이시영의 맥주캔 따는 모습이 명장면”	데일리안
"질리지 않아"…이시영, 불암산 정상에서 뽐낸 '탄탄 각선미' [★해시태그]	엑스포츠뉴스
이시영, 비 맞으면서도 감악산 출렁다리행..소유진 "아찔하다"	헤럴드POP
이시영, 비 오는 날에도 자체발광 미모 ‘청초한 민낯’ [SNS★컷]	뉴스엔
이시영, 싱그러운 과일셔츠+왕골가방…카리스마 벗고 러블리	헤럴드POP
이시영, 시골 친정서 감자 캐며 청순美 과시 [★해시태그]	엑스포츠뉴스
이시영, 비오는 날에도 새벽 등산..역시 프로 등산러	스타뉴스
이시영, 결혼 4년 차에도 20대 뺨치는 '동안 미모'…'쌩얼도 빛나'	스포츠조선
이시영, 이영표X션과 한강 러닝 인증샷 ‘영화 찍는 줄’[SNS★컷]	뉴스엔
'SF8-블링크' 감독 "인간적인 선배 형사 이시영과 인공지능 신입 형사 하준 케...	헤럴드POP
[[김삼웅의 인물열전] 성재 이시영선생 평전] 신흥무관학교 출신들, 무장투쟁...	오마이뉴스
[[김삼웅의 인물열전] 성재 이시영선생 평전] 신흥무관학교 출신들, 무장투쟁...	오마이뉴스
이시영, 군살 제로 건강함의 비결은 등산…"오늘도" [★해시태그]	엑스포츠뉴스
이시영, 청량미 가득…세월 비껴간 미모 [리포트:컷]	TV리포트
‘SF8-블링크’ 감독 “관전 포인트? 이시영·한가람, 케미+액션”	스포츠동아
이시영, 명품백도 우아하게 소화 ‘꽃보다 화사해’ [SNS★컷]	뉴스엔
이시영, 주원과 나란히 닮은꼴 운동메이트..'화기애애'[★SHOT!]	OSEN
이시영 아들, 어른보다 낫네…아쿠아리움에서 바다 걱정하는 30개월	스포티비뉴스
이시영, 션·이영표와 주말 한강 달리기 "반포한강지구 10km" [★해시태그]	엑스포츠뉴스
이시영, 이영표X션과 크루모임 "장정 넷이 만났는데 레모네이드와 딸기에이드...	헤럴드POP
이시영, 실제로 보면 이런 모습? 등산+러닝으로 다진 '건강美' [★SHOT!]	OSEN
[포토] 이시영 '섹시하게'	세계일보
이시영, 실제로 보면 이런 모습? 등산+러닝으로 다진 '건강美' [★SHOT!]	OSEN
이시영, 미니 원피스 입고 여리여리핏..운동으로 탄력美 추가	헤럴드POP
이시영, 독특한 패션도 사랑스럽게 소화 ‘일상이 화보’[SNS★컷]	뉴스엔
이시영, 9등신 비율…아이 엄마 안 믿기는 미모 [★해시태그]	엑스포츠뉴스
이시영, 굴욕없는 근접샷..오히려 청순 비주얼 돋보여	헤럴드POP
이시영, 재킷+레깅스로 자랑한 '독보적 각선미'…몸매가 다했다	스포츠조선
이시영X주원, 건강미 넘치는 근육질 남매..탄탄 팔근육 시선강탈	헤럴드POP
'SF8-블링크' 이시영X하준, 환상적 케미로 시선 압도..깊은 여운 선사	헤럴드POP
이시영, 아들과 물놀이…꿀 뚝뚝 눈빛 [★해시태그]	엑스포츠뉴스
이시영, 30개월 아들 뒷모습 공개..보이진 않아도 사랑스러워	헤럴드POP
이시영, 보랏빛으로 물든 여름날 ‘포인트는 아들이 준 반지’ [SNS★컷]	뉴스엔
이시영, 관악산도 정복한 '프로 등산러'…아찔한 절벽 인증샷	스포츠조선
이시영, 절친 소유진과 관악산 정복 "혼자보단 둘이 올때 더 좋다" [★SHOT!]	OSEN
이시영 "오늘" 정상에서 만끽한 절경 들여다보니?	인천일보
‘SF8’ 한가람 감독 “이시영 운전 너무 잘해, 모든 스태프 놀랐다”	뉴스엔
이시영, 꽃 사이에서 찰칵 '누가 꽃이야?'...마스크로 가릴 수 없는 미모 [★...	엑스포츠뉴스
이시영, 오늘은 운동복 아니고 사복, 여전한 미모 뿜뿜	헤럴드POP
이시영, 흐린 날씨에도 꿋꿋한 새벽 등산..건강한 동안미모 비결	헤럴드POP
이시영, 정원에서도 열일하는 '힐링' 유발하는 미모	뉴스컬처
이시영, 정원에서도 열일하는 '힐링' 유발하는 미모	뉴스컬처
이시영, 럭셔리 아들 방 인테리어 공개…잔디 깔린 테라스 ‘눈길’ [스타★샷...	스포츠월드
이시영, 결혼 후 더 빛나는 미모…'잡티 無 민낯+군살 제로 각선미'	스포츠조선
이시영, 건강미 넘치는 일상 "너무 멋진 수락산" [★해시태그]	엑스포츠뉴스
[포토] 형사 역할로 돌아온 이시영	일요시사
이시영, 시원하게 파인 네크라인…청순+우아美	마이데일리
이시영 부부 성수동 꼬마빌딩, 김성근 전 감독에게 매도 '시세차익 40억'	엑스포츠뉴스
[포토] 이시영 '블랙&화이트'	세계일보
[포토] 이시영 '매력적인 미소'	세계일보
이시영, 훌쩍 큰 아들과 외출 "너무 좋아하네" [★해시태그]	엑스포츠뉴스
이시영, 훌쩍 큰 아들과 외출 "너무 좋아하네" [★해시태그]	엑스포츠뉴스
[포토] 이시영, '건강미 넘치는 그녀'	한국경제
이시영, 티셔츠에 청바지만 입어도 우월…화사한 미모에 '심쿵' [★해시태그]	엑스포츠뉴스
이시영-한가람 감독-하준 '블링크' 배우들	서울경제
'SF8' 이시영, 상큼한 인사	서울경제
[[김삼웅의 인물열전] 성재 이시영선생 평전] '위대한 패배자' 이시영 선생은...	오마이뉴스
이시영, 패셔니스타의 성수동 나들이 '세련美 철철'	헤럴드POP
[오마이포토] 'SF8' SF의 세계로!	오마이뉴스
이시영, 애엄마의 국보급 보디라인..운동의 중요성	헤럴드POP
'셀럽뷰티2' 이시영, 완벽 피부 진정 집콕케어 비법은?	조이뉴스24
'셀럽뷰티2' 이시영, 완벽 피부 진정 집콕케어 비법은?	조이뉴스24
이시영, 잔디 테라스+이층 침대 갖춘 아들 방 사진..깔끔 인테리어	헤럴드POP
'SF8-블링크' 한가람 감독이 직접 꼽은 관전 포인트 #이시영&하준의 케미 #밝...	MBC연예
"소울메이트 급"..소유진x이시영, 육아·운동·취미 다 같이하는 '찐우정♥︎...	OSEN
이시영 "오늘도 수고했어요" 패셔니스트 아우라 들여다보니?	인천일보
이시영, 믿을 수 없는 최강 동안美 '초여름 상큼+풋풋 매력' [★해시태그]	엑스포츠뉴스
이시영, 아침부터 이렇게 예쁘면 반칙…세상 혼자사는 여신 미모	헤럴드POP
이시영, 민낯이어도 눈부셔…싱그러운 청순 비주얼 [★해시태그]	엑스포츠뉴스
"100대 명산"…이시영, 고민시와 북한산 정상 인증샷 [★해시태그]	엑스포츠뉴스
빌딩 두채 동시 매각해 40억 차익 남긴 이시영…매입자는 김성근	뉴스1
이시영, 화사한 꽃무늬 블라우스로 뽐낸 ‘건강 S라인’[SNS★컷]	뉴스엔
이시영X이유비X김지민X혜린, 미녀들의 신나는 회식 현장[SNS★컷]	뉴스엔
김민경, ‘나는 살아있다’ 합류... 김성령X이시영과 생존 도전[공식]	TV리포트
이시영, 반달 눈웃음에 팬들 '심멎'	뉴스컬처
[포토] 이시영 'AI 형사 연기해요'	스포츠조선
이시영, 빨간 멜빵바지 입고 상큼발랄 매력 "대청소·심부름의 날"	헤럴드POP
KBS JOY 셀럽뷰티2, 이시영·이유비 수분 앰플 '릴렉싱 앰플' 소개	데일리그리드
이시영, 아이 엄마 몸매가 이 정도…완벽 바지핏 자랑 [★해시태그]	엑스포츠뉴스
'릴렉싱앰플' 도대체 뭐지? '이시영이 찜한 草000'…캐시워크 돈버는퀴즈 정답...	이코노뉴스
이시영 '점점 더 예뻐지네'[★포토]	스타뉴스
이시영, 노인학대 예방의 날 홍보 "어르신들께 따뜻한 마음 가져주세요"	헤럴드POP
이시영, EXID 혜린과 화려한 미모 대결..여배우 클래스 어디 안가네	헤럴드POP
"이 언니 몇살이야" 이시영, '멜빵'도 찰떡...나이 잊은 패션 소화제 [★SHOT...	OSEN
이연, ‘SF8’ 프로젝트 합류…이연희X이시영과 호흡 [공식]	스포츠동아
'셀럽뷰티2' 이시영, 여름철 유·수분밸런스 고민과 환경 생각하는 파우치 공...	데일리그리드
이시영, 청바지만 입어도 폭발하는 '청순美'	뉴스컬처
‘SF8-블링크’ 감독 “이시영X하준, 액션 연기 소화 잘해” 극찬 [일문일답]	스포츠동아
[bnt포토] 이시영 '형사역 맡았습니다~'	bnt뉴스
'SF8' 블링크, 이시영X하준의 환상적 케미	톱데일리
소유진X이시영, 새벽 등산→아침 러닝 인증 '진정한 운동 메이트' [★해시태그...	엑스포츠뉴스
이시영, 블랙 의상에도 빛나는 비주얼…오늘도 예쁘다	헤럴드POP
"아이 엄마→연예인 변신" 이시영, 소멸 직전 '작은 얼굴'에 고민시 "헐 대박...	스포츠조선
[포토]블링크의 이시영-하준-한가람 감독	헤럴드POP
이시영, 애 엄마 맞아? 스키니 반바지에도 굴욕 無[SNS★컷]	뉴스엔
이시영, 마스크쓰고 뽐낸 데일리룩…선선한 날씨에 딱이야	헤럴드POP
이시영 '섹시한 블랙&화이트'[★포토]	스타뉴스
'셀럽뷰티2' 남다른 '홈캉스'를 즐기는 이시영, 특별한 두피관리 방법에 눈길	시사매거진
이시영, 케이크 들고 러블리 매력 大방출…바이커 팬츠도 거뜬 소화	헤럴드POP
이시영, 피티샵 앞에서 사진 찰칵.."지켜보던 한 남자..오늘 힘든 운동 예상"	헤럴드POP
이연, ‘SF8’ 프로젝트 합류… 이연희-이시영과 호흡	스포츠동아
[[김삼웅의 인물열전] 성재 이시영선생 평전] 이승만, 전시중에 대통령직선제...	오마이뉴스
이시영, 절친 소유진 감탄 부른 셀럽 아우라 "세상 예쁘네"	헤럴드POP
이시영, 거실 청소부터 상추·로메인 심기까지…빛나는 청순 미모	헤럴드POP
이시영, 가슴 강조한 파격 블라우스..청순+섹시	스타뉴스
이시영, 진정한 등산가의 '탄탄한 근육 몸매'…도봉산 정복하며 '신선놀이' [...	스포츠조선
'SF8-블링크' 이시영X하준, 인간과 인공지능의 특별한 수사 액션극	서울경제
'셀럽뷰티2' 2030 트러블 원인? '세대별 트러블 케어' 이시영 혜린이 알려준다	G밸리뉴스
이시영, 잔디 깔린 럭셔리 테라스서 노는 개구쟁이 아들[스타★샷]	스포츠월드
셀럽뷰티2 이어지는 '집콕 챌린지', 이시영, 혜린이 집에서 자신을 가꾸는 비...	G밸리뉴스
답변하는 '블링크' 이시영[★포토]	스타뉴스
답변하는 '블링크' 이시영[★포토]	스타뉴스
이시영, 여리여리한 일상 패션..샤방샤방 '애엄마'[★SHOT!]	OSEN
[사진]이시영,'심쿵 눈맞춤'	OSEN
[사진]이시영,'눈부신 햇살 미소'	OSEN
이시영, 오늘도 싱그러운 미모…미니 원피스로 발랄함 자랑 [★해시태그]	엑스포츠뉴스
이시영, 소요산 등산 인증 “서울 경기 쪽에 산 추천해주세요” [SNS★컷]	뉴스엔
이시영, 쭉 뻗은 각선미..군살 제로 몸매	스타뉴스
[포토] 이시영 '블링크 많이 사랑해주세요!'	세계일보
tvN 측 "오정연, '나는 살아있다' 합류"…김성령·이시영·김민경 만난다 [공...	한국일보
[포토] 이시영 ‘긴장돼요’	스포츠동아
이시영, 대학생 아니야? ‘아들맘 믿기 힘든 비주얼’ [SNS★컷]	뉴스엔
이시영, 청순함이란 이런 것 ‘막 찍어도 화보’ [SNS★컷]	뉴스엔
이시영, 비 오는 날의 데일리룩…마스크는 필수 [★해시태그]	엑스포츠뉴스
이시영, 프로등산러의 여유만만 출렁바위 인증 "이번엔 감악산" [★해시태그]	엑스포츠뉴스
이시영, 싱그러움 가득한 꽃미모…머리부터 발끝까지 명품 비주얼	헤럴드POP
[[김삼웅의 인물열전] 성재 이시영선생 평전] 한국국민당 창당에 앞장서	오마이뉴스
이시영 "감자도 캤다 #아빠모해" 일상의 여유 들여다보니?	인천일보
이시영, 소유진과 7.6km 러닝…"철인3종? 그러기엔 저질체력"	스포티비뉴스
이시영, 감악산 새벽 등산 인증… “출렁다리 너무 예쁜 명소” [SNS★컷]	뉴스엔
이시영, 아침 깨우는 모닝 셀카…청순 비주얼+강렬 눈빛 [★해시태그]	엑스포츠뉴스
셀럽뷰티2 이시영, 고체 샴푸바 '에리제론' 샴푸볼로 지역아동센터 기부	더 기어
"이 미모가 애엄마라니" 이시영, 너무 예뻐서 참 할말이 없네♥ [★SHOT!]	OSEN
이시영, 점프수트만 입었을 뿐인데.. 8등신 모델포스 [리포트:컷]	TV리포트
'셀럽뷰티2' 이시영, 피부관리 대안으로 트로이아르케 에스테틱비비 공개	지피코리아
이시영, 장마 시작해도 등산 챌린지ing…출렁다리 앞에서 '여유만만' [★해시...	엑스포츠뉴스
'SF8-블링크' 오늘 베일 벗는다	광주매일신문
이시영, 잔디 깔린 럭셔리 테라스 공개…아들의 놀이터	스포츠조선
이시영, 꾸안꾸 매력 폭발..세련美 철철 비주얼	헤럴드POP
이시영, 등산도 화보처럼 "비와서 멋진 거미줄, 내 맘대로 포토 스팟" [★해시...	엑스포츠뉴스
이시영&혜린, ‘셀럽뷰티2’ 셀프캠 통해 ‘쏠베라 아르베라 플러스’ 리뷰	아시아에이
이시영, 여름만큼 환한 햇살 미모 ‘사복도 패션왕’ [SNS★컷]	뉴스엔
'절친' 소유진X이시영, 새벽 등산→취미 공유까지…"함께해줘서 고마워♥"[종...	스포츠조선
이시영, 등산 중 포착된 완벽 뒤태… 군살 없는 탄탄 몸매 [SNS★컷]	뉴스엔
이시영 "싹이나오려나.." 청초함 가득 셀피 한 컷	인천일보
이시영, 수락산 암벽 등반까지..건강미 넘치는 일상 [★SHOT!]	OSEN
'어린이집 안 부럽네'…이시영, 새롭게 단장한 아이 방 인테리어 공개	마이데일리
이시영, 3살 아들에게 반지 선물 받았다..“정윤이가 끼워준 반지” 자랑[★S...	OSEN
[포토]이시영, 건강미 뽐내며	스포츠서울
이시영, 가평 나들이 인증샷.."오늘 향기 테라피"	헤럴드POP
이시영, 수수한 모습에도 여전한 미모... 귀여운 일상 공개 [★해시태그]	엑스포츠뉴스
[포토]포즈 취하는 이시영-한가람 감독-하준	이데일리
[포토S] 이시영, 시크한 미소	스포티비뉴스
이시영, '프로등산러'는 잊어라…화려한 연예인 포스 [★해시태그]	엑스포츠뉴스
이시영, 사복 여신의 일상 “오늘 날씨”	한국일보
“돈 주고 살 수 없는 힐링”...이시영, 등산 요정의 청순미모 [리포트:컷]	TV리포트
이시영, 빨간 멜빵바지 입고 과즙미 넘치는 일상 "대청소의 날" [★해시태그]	엑스포츠뉴스
[포토] 이시영-하준 '우리는 인공지능 형사'	스포츠조선
이시영, 절친 소유진과 청계산 정복 ‘탄탄 각선미 비결’ [SNS★컷]	뉴스엔
'백종원♥'소유진, 이시영과 새벽 관악산 등반 인증…'부지런한 미녀들'	스포츠조선
이시영, 트레이닝 레깅스에도 군살 제로 몸매 '부러운 건강미'	헤럴드POP
'SF8' 감독들이 본 #이연희 #이시영 #최성은 #유이 #하니	한국일보
[사진]이시영,'사랑스러운 눈맞춤'	OSEN
[[김삼웅의 인물열전] 성재 이시영선생 평전] 한국독립당 창당, 감찰위원장 맡...	오마이뉴스
[N년 전 오늘의 XP] '복싱 챔피언' 이시영, 시구 솜씨도 챔피언급	엑스포츠뉴스
이시영X하준의 ‘블링크(Blink)’, SF8 제작보고회 풀 영상 [뉴스엔TV]	뉴스엔
이시영, 오늘도 미모 한도초과…청순 비주얼 '심쿵' [★해시태그]	엑스포츠뉴스
'프로등산러' 이시영, 오늘도 등산 삼매경...이번엔 청계산 [★SHOT!]	OSEN
이시영, 팔굽혀펴기의 정석→성난 등근육+초콜릿 복근··완벽 몸매	헤럴드POP
장흥 용산면, ‘곱디고운 그때’ 청춘회복 프로그램 운영	스카이데일리
'셀럽뷰티2' 이시영 부기케어, 운동 후 부기 빼는 비법은 '발바닥패치'	CCTV뉴스
[포토S] 인사하는 '형사' 이시영	스포티비뉴스
[[김삼웅의 인물열전] 성재 이시영선생 평전] 이승만의 오만ㆍ독선 지켜보며	오마이뉴스
[포토] 이시영, ‘설렘주는 미소’	파이낸셜뉴스
이시영, 김구라→솔비 초대해 럭셔리 테라스서 홈파티 ‘레스토랑급 요리’[★...	OSEN
이시영, 크롭톱도 소화…센스 만점 사복 패션	마이데일리
이시영, 청바지로 뽐낸 비율 정점 ‘여유 가득 일상’ [SNS★컷]	뉴스엔
이시영, 패션 소화력 만점...에스닉 원피스로 독특한 매력 물씬 [★해시태그]	엑스포츠뉴스
이시영 "오늘은 대청소와 심부름의날" 화사함 가득 셀피 한 컷	인천일보
'등산왕' 이시영, 이번에는 감악산 정복…출렁다리까지 클리어 [★SHOT!]	OSEN
이시영, 얼굴보다 더 예쁜 마음씨…"어르신들께 따뜻한 마음 가져주세요" [★...	엑스포츠뉴스
이시영, 세련美가 철철…마스크로 가릴 수 없는 블링블링 비주얼	헤럴드POP
[사진]이시영,'조심스럽게 계단을 오르며'	OSEN
[MD포토] 이시영-하준, 'SF8-블링크의 주역들'	마이데일리
‘나는 살아있다’ 측 “오정연 합류” 김성령 이시영 김민경과 생존전사 도전...	뉴스엔
이시영, 애 엄마 맞아? 감탄 나오는 미모+날렵 턱선[SNS★컷]	뉴스엔
[포토] 'SF8' 이시영-하준-한가람 감독, '블링크'의 주역들	마켓뉴스
[포토]'SF8' 이시영, '빛나는 미소'	조이뉴스24
셀럽뷰티2, 이시영&혜린 쏠베라 '아르베라 플러스' 에센스 소개	데일리그리드
이시영, 청순 글래머 매력 대방출…아이 엄마 안 믿기는 상큼함 [★해시태그]	엑스포츠뉴스
이시영, '청청'까지 찰떡...'패션 소화력' 만렙 [★SHOT!]	OSEN
이시영, 슬리퍼 신고도 우월한 비율..오늘도 예쁨 폭발	헤럴드POP
이시영, 체지방률 9.8% 환상 몸매…등산이 다이어트 비결	스포츠조선
“와 이 복근으로...?” 역대급 능력치 가진 여자판 '가짜 사나이' 출연자들 ...	위키트리
이시영, 3만 7천원 해외직구 꽃양말 활용법 "아름다운 희생"	헤럴드POP
김수로, 이시영과 훈훈 투샷..'만수로' 인연	스타뉴스
이시영 시세차익 40억 '대박'…김성근 감독에 꼬마빌딩 매도	텐아시아
소유진X이시영, '7.6km' 아침 운동 인증…몸매 비결은 '조깅+등산'	스포츠조선
"떨렸다"..소유진X이시영, 미녀들의 등산→티타임	스타뉴스
[포토] 이시영, ‘청순한 분위기 여인’	파이낸셜뉴스
[포토] 이시영, ‘심플한 블랙 앤 화이트’	파이낸셜뉴스
[포토] 이시영, ‘심플한 블랙 앤 화이트’	파이낸셜뉴스
이시영·EXID 혜린, 여름 뷰티템으로 바이오톡 '3X 크로스링크 앰플' 극찬	더구루
전혜빈, '이시영'과 싸우면?‥"내가 100% 질 것!" 과거 발언	뉴스컬처
이시영, 재킷+레깅스 조합으로 완성한 청순 미모 “반하겠어” [SNS★컷]	뉴스엔
이시영 "오늘 이 바지는 진짜 만능 바지임" 일상에서 뽐낸 아우라	인천일보
이시영, 시골 친정서 아들과 감자캐기 ‘귀요미 외모+고사리손’[Oh!마이 bab...	OSEN
'셀럽뷰티2' 이시영· EXID 혜린의 녹차 이용한 '애프터 썸머 케어' 공개	더 기어
이시영, 엄마 쏙 빼닮은 붕어빵 아들 공개..아들과 알콩달콩 잼 만들기[Oh!마...	OSEN
이시영, 5일 운동 쉰 몸매가 이 정도? 슬림+탄탄 완벽 몸매	스포츠조선
KBS Joy 뷰티 프로그램 ‘셀럽뷰티2’, 이시영&혜린 ‘쏠베라’ 아르베라 플러...	투어타임즈
[포토] 이시영 ‘재미있는 촬영이었어요’	스포츠동아
[포토]'SF8' 이시영, '청순+섹시 패션'	조이뉴스24
이시영, 운악산 미륵바위도 정복…건강美 넘치는 일상 [★해시태그]	엑스포츠뉴스
이시영, 3살 아들 방 꾸미기 삼매경…귀염뽀짝 뒷모습 '심쿵' [★SHOT!]	OSEN
이시영, 물오른 청순 미모에 시선 고정..."#셀럽뷰티2"	뉴스컬처
이시영, 카페 뺨치는 집 공개 "드디어 거실 싹 정리"	마이데일리
이시영 "오늘 #향기테라피#아로마테라피 하려고 가평행" 들여다보니	인천일보
이시영, 10km 뛰고 "운동끝나고 마시는 물이 우주세계최고맛"[★SHOT!]	OSEN
이시영, 흰 티만 입어도 빛나는 비주얼…언제나 청순한 미모 [★해시태그]	엑스포츠뉴스
이시영 `건강 미인` [MK포토]	MK스포츠
이시영, 초여름 레더 스타일링 “매력↑”	TV리포트
이시영 "민시랑 100대 명산에 가보기로 하였다" 고민시와 다정하게 한 컷 '훈...	인천일보
이시영, 주말에도 열일하는 패셔니스타..올검의 시크녀	스타뉴스
소유진x이시영, ‘폭염주의보’도 못 꺾는 운동 열정…함께 청계산 등산 인증	세계일보
KBS Joy '셀럽뷰티2' 이시영, 혜린 체형교정 도움되는 닥터바르미 제품 공개	시사매거진
이시영, 흰티에 청바지+롱재킷 입고 우월핏..169cm라 뭔들 다 잘어울려	헤럴드POP
이시영, 세상 건전한 크루 공개.."맥주? 레모네이드+딸기에이드..이렇게 또 배...	OSEN
김수로, 연극 응원 온 이시영과 훈훈 투샷···반가운 '만수로' 케미	일간스포츠
‘셀럽뷰티 2’ 이시영·혜린 2030 민감피부 관리법 공개	보건뉴스
소유진, 이시영과 새벽 5시 동반 등산 "고맙다 친구야"	스타뉴스
이시영, 애엄마 맞아?‥배꼽티까지 찰떡 소화하는 천상 연예인	헤럴드POP
이시영, 점프슈트+마스크 매치..패셔니스타의 면모[★SHOT!]	OSEN
이시영, 한껏 물오른 미모의 근황 공개…‘한결같이 예쁨’ [스타★샷]	스포츠월드
"밧줄 놓치면 끝"…이시영, 고난도 암벽 등반 마스터→극기훈련 다짐까지	스포티비뉴스
배우 이연 ‘SF8’ 프로젝트 합류… 이연희X이시영과 호흡	스포츠경향
소유진X이시영, 관악산 등반 인증샷…여전한 '특급 우정'	마이데일리
이시영, 럭셔리 테라스서 귀염뽀작 아들 뒤태 공개 “새 잔디 너무 좋아해”[...	OSEN
미주지역 독립운동과 친이승만 세력의 동향①	통일뉴스
sf8 '블링크' 한가람 감독 "낙천적, 희망적인 SF로 다가가고파"	이데일리
[HS포토] 이시영, '블링크'에서 만나요	한스경제
[HS포토] 이시영, '블링크'에서 만나요	한스경제
이시영, 여대생이라 해도 믿을 풋풋한 동안美..애엄마가 이렇게나 예뻐	헤럴드POP
[포토]이시영, 화이트 앤 블랙으로 세련되게!	스포츠서울
이시영, 등산 챌린지→유명산 정복…"이름처럼 유명해지면 좋겠다" [★해시태...	엑스포츠뉴스
이시영, 청순美 가득 미모는 여전해...'심쿵 유발자'	뉴스컬처
"청순 글래머의 정석"…이시영, 블라우스 하나로 '올킬' [리포트:컷]	TV리포트
이시영, 민낯에 흩날리는 머리카락..점프수트 입고 내추럴 매력 뿜뿜	헤럴드POP
이시영, 김구라→솔비와 초호화 럭셔리 테라스서 홈파티[SNS★컷]	뉴스엔
이시영, 엄마의 변신은 무죄…배꼽 드러내고 '청순 완벽핏' [★해시태그]	엑스포츠뉴스
이시영, 출산 후에도 변함없는 탄탄 몸매→'건강美 비결'은 100대 명산 등산	스포츠조선
KBS JOY 셀럽뷰티2, 이시영 여름철 피부 관리 녹차 팩으로 인워드 '아가스 아...	데일리그리드
솔비X이시영X설민석, 김구라 새 출발 축하파티 "세상 따뜻한 남자"	헤럴드POP
이시영, 시골 친정서 감자 캐는 청순 미녀[SNS★컷]	뉴스엔
'셀럽뷰티2' 이시영, 혜린이 소개한 청결한 패키지 용기 '자극방패크림'	데일리그리드
이시영, '슬림+탄탄 몸매' 뽐내며 깜짝 파티 준비…'사랑스러운 미소는 덤'	스포츠조선
이시영, 오늘도 등산..이 정도면 프로등산러 “100대 명산에 가보기로 했다”...	OSEN
이시영, 생애 첫 연계 산행 기진맥진 "등산 시간 8시간 반" [★SHOT!]	OSEN
이시영, 일요일에도 예쁨 폭발..한껏 꾸미고 어디로?[★SHOT!]	OSEN
이시영, 아로마테라피 위해 춘천行…"너무 감사한 시간" [★해시태그]	엑스포츠뉴스
'나는 살아있다' 김성령→오정연 출연, 707부대 출신 박은하 교관 낙점	티브이데일리
이시영 `매력적인 분위기` [MK포토]	MK스포츠
[[김삼웅의 인물열전] 성재 이시영선생 평전] 넷째형 이회영으로부터 양명학 ...	오마이뉴스
이시영, 럭셔리 하우스서 수영장 만드는 ♥︎남편 공개..아들까지 가족 완전체...	OSEN
KBS Joy 셀럽뷰티2, 이시영∙이유비 하이포레스트 '탈모샴푸' 소개	미래한국
[SC현장]'SF8' 이연희X유이X안희연X이시영…무한 상상력→슈퍼판타지의 大향연...	스포츠조선
KBS Joy '셀럽뷰티2' 이시영 혜린 닥터바르미 제품을 통한 체형교정 노하우 소...	시사매거진
[포토] 이시영-한가람-하준, '블링크 기대해주세요'	한국경제
이시영, 아찔한 바위도 거뜬한 '프로등산러'…오늘은 불안산 정복	스포츠조선
이시영, 용산에서 무얼 보고 있는 걸까..옆모습도 예쁘네	헤럴드POP
이시영 ,명품백 메고 '꽃보다 아름다운 미소'…출산 후에도 가녀린 몸매 [종합...	스포츠조선
이시영 ,명품백 메고 '꽃보다 아름다운 미소'…출산 후에도 가녀린 몸매 [종합...	스포츠조선
‘나는 살아있다’ 박은하ㆍ김성령ㆍ이시영ㆍ김민경ㆍ오정연ㆍ김지연ㆍ우기, ...	비즈엔터
이시영, 잔디 깔린 옥상에서 여유만끽하는 3살아들에 흐뭇…"너무 좋아하네"	스포티비뉴스
[E포토] 이시영, 'SF8로 인사드립니다'	SBS funE
이유영X예수정X이연희X이동휘X이시영X하준X장유상 SF8 제작보고회 포토타임 [...	뉴스엔
이시영, '화난 등근육-식스팩' 다이어트 자극 '갓벽' 몸매 [★SHOT!]	OSEN
MBC 시네마틱드라마 'SF8-블링크' 오늘(4일) 베일 벗는다!	문화뉴스
이연, ‘SF8’ 프로젝트 ‘만신’×‘블링크’ 캐스팅… 이연희×이시영과 호...	MBC연예
이시영, 근접 미모가 이 정도면 '반칙' 아니야?...'시선 올킬'	뉴스컬처
이시영, 소유진과 레깅스 입고 각선미 대결…함께 등산하는 '특급우정'	스포티비뉴스
"혼자보단 둘" 소유진X이시영, 등산으로 가꾼 건강美…미녀들의 우정ing [엑'...	엑스포츠뉴스
이시영, 마스크 뚫는 청순美...예쁨 한도 초과	뉴스컬처
이시영, 운동으로 다져진 완벽한 몸매 비율…'세련된 여신미'	스포츠조선
이시영, 3살 아들 데리고 전혜빈·기은세와 여름여행 만끽…미녀들의 우정	스포티비뉴스
서울E, '라스 헤더골+선두 탈환' 수원FC에 0-1 패배	OSEN
[TEN 포토] 'SF8' 이시영, '자신감 넘치는 발걸음'	텐아시아
[TEN 포토] 'SF8' 이시영, '볼륨감 드러낸 상의'	텐아시아
이시영, 초호화 럭셔리 테라스에 잔디 깔았다 “아들도 좋아해”	뉴스엔
'이시영 부부' 성수동 꼬마빌딩, 김성근 감독에게 팔았다…시세차익 40억원	머니투데이
'SF8' 인간과 인공지능의 환상적인 공조!	광주매일신문
[E포토] 이시영, 'SF8 블링크의 미모의 형사'	SBS funE
이시영 몸매 비결은 등산? 검단산 정상 정복 “1kg 족히 빼”[SNS★컷]	뉴스엔
이시영, 군살 없는 탄탄 몸매…청순美는 덤 [★해시태그]	엑스포츠뉴스
이시영, 청계산 등산 인증샷…폭염도 막지 못한 열정 [★해시태그]	엑스포츠뉴스
이시영, 미모 만큼이나 훈훈한 마음씨..."어르신들께 따뜻한 마음을 가져주세...	뉴스컬처
소유진 vs 이시영, 같은 옷 다른 느낌…"원피스만 265만원"	머니투데이
[포토Q] 이시영 '빛이 나는 미모'	스포츠Q
소유진, 절친 이시영과 등산 후 카페.."칼같이 헤어졌는데 처음으로, 떨렸다"	헤럴드POP
이연, SF8 프로젝트 합류 '만신'X'블링크' 출연…이연희·이시영과 호흡	엑스포츠뉴스
이시영, 아슬아슬 출렁다리 위 ‘보기만 해도 아찔’ [SNS★컷]	뉴스엔
이시영, 션·이영표·조원희와 한강 10km 러닝 인증샷 “감사합니다”[★SHOT...	OSEN
이시영, 3살 아들이 만든 딸기청 자랑 “너의 첫 딸기잼”[Oh!마이 baby]	OSEN
이시영, 뛰어난 패션 센스에 시선 고정...'비율 천재'	뉴스컬처
이시영 국대급 몸매…이 각선미 실화냐	매일경제
[단독] 배우 이시영 부부 꼬마빌딩, 김성근 감독이 매입…40억 시세차익	매일경제
'백종원♥' 소유진, 이시영과 새벽 등산 인증 "참 좋았다"	TV리포트
기은세, 정원 가꾸는 럭셔리 일상…이시영 "너무 예쁘다" 감탄	스포츠조선
이시영, 등산에 이어 헬스까지··운동으로 다져진 탄탄 몸매, 애는 누가 낳았...	헤럴드POP
이시영 '100대 명산' 등산 프로젝트…군살 제로 몸매 인증샷	헤럴드POP
이시영, 인스타그램으로 전한 유튜브 채널 오픈 예고…"같이 등산 다녀요"	톱스타뉴스
KBS Joy '셀럽뷰티2' 이시영×혜린이 선택한 바른자세를 위한 잇템, 닥터바르...	테크월드
이시영, 체지방률 9.8%인 비결 있었네..다이어트 식단 공개[★SHOT!]	OSEN
셀럽뷰티2, '드래곤시카 크림' 소개...꿀팁 전도사 배우 이시영, 아이돌 혜린...	G밸리뉴스
'나는 살아있다' 김성령→우기, 생존 의지 200%…비장함 가득 메인 포스터 공...	싱글리스트
이시영, 불곡산 정상 아찔한 높이 바위 위에서 찰칵..한 폭의 그림	헤럴드POP
이시영, 캐주얼한 일상 모습도 눈부셔...“사자상도 반하겠네” [리포트:컷]	TV리포트
소유진 "이시영과 등산 후 칼같이 헤어졌는데 처음으로…떨렸다" [★해시태그...	엑스포츠뉴스
'셀럽뷰티2' 이시영·혜린, 피부뿐만 아닌 세균 방패까지...'방패케어' 공개	G밸리뉴스
이시영 부부 꼬마빌딩, 김성근 감독 매입…40억 시세차익	스포츠월드
이시영, 등산으로 다져진 명품 몸매..탄탄+글래머	헤럴드POP
이시영, 거울 셀카도 '청순 그 자체'...크롭 스타일도 찰떡 소화	뉴스컬처
셀럽뷰티2 이시영의 잇템 ‘V7 안티헤어로스 샴푸’ 셀프 관리법 공개	더퍼블릭
'다이어트'하는데 '식욕' 터져 스트레스 받는다 호소한 이시영	인사이트
이시영, 3살 아들 엄마의 화려한 변신…무결점 몸매 비결은 등산?	스포티비뉴스
'SF8-블링크' 이시영 "AI와 어떻게 조화를 이뤄야 하느냐를 다뤘다"	MBC연예
이시영, 운동 못 가도 탄탄한 몸매...트레이너 생일 축하 [★해시태그]	엑스포츠뉴스
‘SF8’ 이시영 “아날로그에 애착 있었지만‥AI에 대한 생각 바뀌어”	뉴스엔
KBS joy 셀럽뷰티2, "이시영이 알려주는 럭셔리 홈케어 비법"	열린뉴스통신
이시영, 감탄 나오는 레깅스 자태 ‘탄탄 허벅지+완벽 각선미’ [SNS★컷]	뉴스엔
솔비·김구라·설민석, 이시영 초호화 집서 만찬 "존재 자체가 영감" [★해시...	엑스포츠뉴스
이시영, 불볕더위 불구 등산 인증샷 ‘더위도 비켜간 건강美’ [SNS★컷]	뉴스엔
시네마틱드라마 'SF8-블링크' 이시영x하준, 인간과 인공지능의 판타스틱한 공...	엔터미디어
이시영, 속눈썹까지 잘생긴 아들과 수영장 데이트 “내사랑♥︎ 예쁘다”[Oh!...	OSEN
[포토] 이시영-한가람 감독-하준, '블링크'의 얼굴들	MBC연예
이시영, 마스크로 가려지지 않는 '청순美'‥뷰티 전도사 '위엄' [★SHOT!]	OSEN
KBS Joy '셀럽뷰티2' 이시영 혜린 체형교정 노하우로 닥터바르미 제품 선보여	CCTV뉴스
'백종원♥︎' 소유진, 또 아침 등산으로 시작한 건강한 하루(ft. 이시영) [★...	OSEN
이시영, 군살 하나 없는 탄탄한 몸매…'살짝 보이는 매끈 복근'	스포츠조선
[포토]SF8 제작보고회 무대에 오르는 이시영	스포츠서울
이시영·조승현 부부, 건물 동시 매각 '40억 차익'…김성근 감독 매입	마이데일리
[포토]SF8 제작보고회 무대에 오르는 이시영	스포츠서울
이시영·조승현 부부, 건물 동시 매각 '40억 차익'…김성근 감독 매입	마이데일리
이시영, 부족한 게 뭐야? 조각 같은 옆태에 팬들 ‘심쿵’ [SNS★컷]	뉴스엔
이시영-하준-한가람 감독 `블링크 기대하세요` [MK포토]	MK스포츠
포즈 취하는 이시영-한가람-하준	뉴스핌
'SF8' 제작보고회 참석하는 이시영	뉴스핌
'백종원♥' 소유진, 이시영과 아침 운동 "7.6km 러닝" [★SHOT!]	OSEN
셀럽뷰티 이시영과 혜린, 마사지기 이용한 ‘집콕 케어’ 방법 공개	투어타임즈
이시영 부부, 갖고 있던 빌딩 팔아 4년 만에 '40억' 차익 얻었다	인사이트
소유진, ♥백종원보다 이시영 자주 보네..이번엔 청계산 카페 데이트 [★SHOT...	OSEN
[포토]이시영-한가람 감독-하준, 우린 '블링크' 팀!	스포츠서울
이시영, 자연 만끽 힐링…운동으로 다져진 늘씬 몸매	헤럴드POP
이시영, 운동으로 다진 탄탄 몸매..기럭지+건강미 독보적	헤럴드POP
이시영, 도봉산 등반 인증… 절친 소유진과 함께 갔나 [SNS★컷]	뉴스엔
이시영, 잘록 개미허리+극세사 각선미…군살제로 종잇장 몸매	헤럴드POP
이시영, 애 엄마 맞아? 슬리퍼 차림에도 길쭉 기럭지[SNS★컷]	뉴스엔
이시영, 나무 화분으로 꾸며진 거실 공개 “분위기 너무 좋아” [SNS★컷]	뉴스엔
“지식을 생산하는 혁신 통해 사회변혁의 불씨 살려야”	동아일보
이시영, 빨간 멜빵바지 입고 러블리 일상 “대청소와 심부름의 날” [SNS★컷...	뉴스엔
이시영, 살 쪘다고? 탄탄+늘씬 각선미 “3개월 운동한 거 1주 만에 회수”[★...	OSEN
이시영, 자체발광 '민낯 여신'…싱그러운 미소는 덤 [★해시태그]	엑스포츠뉴스
셀럽뷰티2, '자극방패크림' 청결한 패키지 용기 소개	미래한국
[포토]SF8 - '블링크'의 한가람 감독과 배우 이시영-하준	스포츠서울
이시영X혜린vs이유비X김지민 치열한 대결 '셀럽뷰티2'에서 공개	뉴스렙
이시영, 내추럴한 일상 모습도 눈부셔 “청순미 한도 초과” [리포트:컷]	TV리포트
이시영, 수수해도 예쁨 폭발.."이 바지는 진짜 만능 바지"	헤럴드POP
이시영, 독보적 건강미…등산복 입고 군살제로 몸매 자랑	헤럴드POP
'SF8' 걸크러쉬 매력 폭발! 이시영X한가람 감독의 신선한 만남 '블링크' 시선...	엔터미디어
이시영, 애 엄마 맞아? 볼륨 몸매 드러난 블라우스 핏[SNS★컷]	뉴스엔
이시영, 아침 등산으로 완성한 건강 몸매..'실루엣이 예술'[★SHOT!]	OSEN
이시영, 아침 등산으로 완성한 건강 몸매..'실루엣이 예술'[★SHOT!]	OSEN
이시영, 스타일리시 데일리룩…자기관리甲다운 늘씬 몸매	헤럴드POP
'셀럽뷰티2' 이시영, 실제 사용하는 뷰티 아이템 '패드 제품' 소개	데일리그리드
이시영, 다이어트 중 식욕 고충 “요즘 입이 터졌다”[SNS★컷]	뉴스엔
이시영, 운동으로 완성한 극세사 몸매..'탄탄 건강미'[★SHOT!]	OSEN
배재대 이시영 교수, 국토부 장관상 수상	뉴시스
KBS Joy 셀럽뷰티2, 집콕케어 피부관리기 '시봉마사지기' 공개	미래한국
이시영, 부었다기엔 탄력 넘치는 몸매 "3개월 운동 일주일만 회수"	헤럴드POP
이시영, 고민시와 등산 인증 “너 2㎏은 빠진 것 같아”[SNS★컷]	뉴스엔
배우 이시영 부부, 성수동 꼬마빌딩 매각으로 40억 시세차익	MBN
이시영, 사패산도 거침없이 오르네..내추럴 미모+탄탄 몸매	헤럴드POP
이시영, 긴 생머리 휘날리며 청순미 과시 ‘분위기 맛집’ [SNS★컷]	뉴스엔
김민경 합류, 김성령, 이시영과 호흡!	내외뉴스통신
이시영, 한여름 햇살 같은 싱그러움 ‘눈빛이 초롱초롱’ [SNS★컷]	뉴스엔
[팝업★]"건강한 친구" 소유진, 이시영과 관악산 정상‥프로등산러의 길(종합...	헤럴드POP
이시영, 블랙으로 꾸며낸 시크미 ‘분위기 여신’ [SNS★컷]	뉴스엔
이시영, 가을 느낌 물씬나는 청순한 니트 패션..긴생머리 그녀	뉴스인사이드
'셀럽뷰티2' 이시영과 혜린, '에리제론' 친환경 고체 샴푸 이용한 유·수분 밸...	데일리그리드
'셀럽뷰티2' 10년은 젊어보이는 피부, 이시영,혜린의 '타임리스 케어' 공개	시사매거진
이시영, 5일 운동 쉬어도 군살 하나없는 퍼펙트 몸매 "한 달 쉰듯" [★SHOT!]	OSEN
이시영-한가람-하준 'SF8 블링크 꼭 보세요'[★포토]	스타뉴스
이시영 아들 정윤, 엄마 닮아 금손 인증 “첫 딸기잼” [SNS★컷]	뉴스엔
[MHN 현장] 'SF8' 제작보고회 현장, SF에 도전한 8인의 감독과 16인의 배우들	문화뉴스
[오늘의CEO]이시영 엑사비스 대표 "향후 보안, '제로데이' 대응에 달렸다"	전자신문
비 한혜진 최은주 이시영, 최고의 복근은?[★NEWSing]	스타뉴스
이시영, 내추럴 여신 ‘블랙으로 무장한 비율 천재’ [SNS★컷]	뉴스엔
"첨으로 음료 마셔" 소유진X이시영, 등산으로 다져진 '늘씬+탄탄' 몸매 과시	스포츠조선
“꽃보다 예뻐”...이시영, 꽃다발 든 일상모습도 화보 [리포트:컷]	TV리포트
이시영, 타이트한 반바지도 완벽 소화 '우월한 몸매' [★해시태그]	엑스포츠뉴스
'SF8' 이시영, "아날로그에 애착... '블링크' 촬영하며 생각 변화"	스타데일리뉴스
이시영, 무더위에도 꾸준히 등산…美친 몸매 '눈길' [★해시태그]	엑스포츠뉴스
셀럽뷰티 최애 화장품, 이시영이 선택한 '부빼 수분탄탄 수면팩' 눈길	한국면세뉴스
[포토] 이시영-한가람-하준 '블링크 많이 사랑해주세요!'	세계일보
이시영, 매일 등산하더니 이 각선미 실화?…마네킹 몸매 [★해시태그]	엑스포츠뉴스
이시영 부부, 김성근 감독에 빌딩 매도…시세차익 40억	뉴스엔
[Ma 현장] 'SF8-블링크' 이시영 "아직 감을 믿는 편, 아날로그적인 것에 애착...	마켓뉴스
이시영, 멀리서 봐도 예쁨 폭발..여리여리한 몸매	헤럴드POP
소유진X이시영, 마스크 끼고 관악산 정복 “건강한 친구야!”[SNS★컷]	뉴스엔
이시영, 아찔한 높이 바위 올라도 여유롭게 “여기가 불암산 핫플” [SNS★컷...	뉴스엔
'운동하는 언니' 이시영 "우리 모두 이겨낼꺼에요" 의료진 향한 진심 어린 응...	기호일보
'운동하는 언니' 이시영 "우리 모두 이겨낼꺼에요" 의료진 향한 진심 어린 응...	기호일보
배재대 이시영 조경학과 교수 국토부 장관상 수상	충청투데이
이시영 “혼자보다 둘, 둘보다 셋이 좋아” 상쾌한 아침 등산 인증 [SNS★컷]	뉴스엔
이시영, "3개월 운동 일주일 만에 회수"…늘씬+탄탄 몸매	마이데일리
이시영, 마스크 쓰니 얼굴이 더 작아..여리여리 몸매	헤럴드POP
[S포토] 이시영, '머리 넘기시영' (SF8)	스타데일리뉴스
영화와 드라마의 좋은 만남, 'SF8' 도전 통할까(종합)	한국경제
'나는 살아있다' 김민경→(여자)아이들 우기, 출연 확정…처절한 생존훈련	싱글리스트
[포토] 이시영-한가람 감독-하준 ‘블랙&화이트 패션’	스포츠동아
이시영 배재대 조경학과 교수, '조경의 날' 기념 국토부 장관상 수상	충청뉴스
오늘(8일) 'SF8' 제작보고회 등장한 이시영, 복싱으로 다져진 건강미!	위키트리
이시영, 출산 후에도 군살 하나 없는 완벽 몸매…이 여름 패셔니스타[★해시태...	엑스포츠뉴스
셀럽뷰티 시즌2 '첫방' 이시영, 아이돌 혜린의 자극방패 추천템 '드래곤시카 ...	Queen
[TD포토] 이시영 '그림자도 완벽!'	티브이데일리
이시영, 결혼 후 리즈 갱신하는 인형 미모+한 줌 허리 ‘늘씬 몸매’[★SHOT!...	OSEN
[아시아 실리콘밸리 판교 100] 네트워크 보안 사각 없앤 엑사비스의 NetArgos...	에이빙뉴스
'SF8' 이시영 "평소 감·아날로그적인 것에 애착…AI 놀라움 느꼈다"	조이뉴스24
굿네이버스광주전남본부, 용산면에 아동 생활용품 기탁	스카이데일리
[포토] 이시영-한가람-하준, ‘블링크 기대하세요’	파이낸셜뉴스
이시영, 등산으로 가꾼 탄탄 몸매 '완벽 등산복 패션+강렬한 눈빛' [★해시태...	엑스포츠뉴스
'SF8'는 한국판 SF 종합세트…"다양한 감독 모여 만든 영화"	뉴시스
이시영, 등산으로 가꾼 탄탄 몸매 '완벽 등산복 패션+강렬한 눈빛' [★해시태...	엑스포츠뉴스
이시영, 체지방률 9.8% 감량→아이 엄마 안 믿기는 청순 글래머 몸매 자랑[종...	OSEN
이시영, 청초한 여름 여신..점프수트 완벽 소화한 몸매	헤럴드POP
이시영, 등산 마니아다운 면모 “다음에 친구 언니들 다 데려와 극기훈련” [...	뉴스엔
셀럽뷰티2 셀럽도 반한 리프레쉬 바이 리엔케이 '드래곤시카 크림'	데이터넷
[TD포토] 이시영 '건강한 구루빛 피부'	티브이데일리
셀럽뷰티2 MC 이시영, 매끈하고 어려 보이는 피부비결 팁 ‘릴렉싱 앰플’ 소...	이투데이
[포토]SF8 제작보고회, 작품 '블링크'의 이시영-한가람 감독-하준	스포츠서울
SF8 '블링크' 이시영·하준 '케미' 매력… 한가람 감독이 밝힌 관전 포인트	뉴스웍스
이시영, 청순美 폭발한 반가운 근황…"셀럽 뷰티2 녹화"	뉴스인사이드
이시영, 과감 노출 글래머 몸매 강조 의상..등산으로 다져진 탄탄 비주얼[★S...	OSEN
'PO 노리는' 서울E, 안양과 1-1 '3G 무패-3위 유지'	OSEN
[S포토] 이시영-한가람 감독-하준, '블링크' (SF8)	스타데일리뉴스
이연희부터 유이까지…'SF8' 감독들이 전한 '내 배우' 매력 [엑's 현장]	엑스포츠뉴스
"우리만의 음악, 우리만의 흥이 세계에 울려퍼지길 바라요"	전남일보
‘SF8’ 이연희→이시영→이유영 총출동... 로맨스·수사·호러·미스터리 다...	TV리포트
김구라X솔비X설민석, 이시영 요리실력에 감탄 “너무 잘먹어”[SNS★컷]	뉴스엔
"의리녀, 감사한 하루"…'돌아온다' 김수로, 이시영과 훈훈 투샷 [★해시태그...	엑스포츠뉴스
[TD포토] 이시영 '오랜만에 인사 드려요'	티브이데일리
콘텐츠 강화한 웨이브, 오리지널 'SF8' TV보다 앞서 공개	글로벌이코노믹
[HS포토] 하준-이시영-한가람 감독, '블링크' 함께 만들었어요	한스경제
원주시, 병원·브로커 개입된 교통사고 가짜환자 점검	오마이뉴스
소유진 "등산 좋아하는 시영이 매니저님~ 맛집 좋아하는 우리 매니저 ㅎ" 이시...	인천일보
셀럽뷰티 이시영·혜린, 'R' 브랜드 자극방패크림 '드래곤시카 크림' 주목	내외뉴스통신
이시영 릴렉싱앰플, 캐시워크 돈버는퀴즈 정답 공개	충청리뷰
'SF8' 이시영 "AI 논란 많이 생각"..하준 "털털한 인공지능 연기"	스타뉴스
[패션엔 포토] 이시영, 출산후에도 몸매 비율 '완벽 그 자체'	패션엔
하이포레스트 샴푸, KBS Joy 셀럽뷰티2 두피&탈모케어로 소개	서울경제TV
장흥군 용산면, 주민 공감 '대화의 장' 열어	뉴스워커
장흥군 용산면, 주민 공감 '대화의 장' 열어	뉴스워커
원주시, 교통사고 입원환자 관리 실태 민관 합동 점검	뉴시스
KBS Joy '셀럽뷰티2'서 이시영·혜린팀, 닥터바르미 베개·방석 소개	내외뉴스통신
[포토Q] 이시영-하준-한가람 감독 'SF8 '블링크'의 주역들'	스포츠Q
이시영, 탄탄 몸매 비결 등산? “오늘도” [SNS★컷]	뉴스엔
'SF8' 이시영 AI파트너 하준, 액션 콤비플레이 '블링크'	싱글리스트
셀럽뷰티2, 이시영의 두피탄력케어, 하이포레스트 샴푸	환경일보
"이연희의 변신→최성은의 발견"...'SF8', 감독들 밝힌 캐스팅 만족도 (종합)...	OSEN
[ST포토] 이시영 '오늘도 아름다워'	스포츠투데이
조이부터 김나영까지! 스타들의 샌들 더하기 양말 스타일링 팁	엘르
[ST포토] 이시영 '오늘도 아름다워'	스포츠투데이
조이부터 김나영까지! 스타들의 샌들 더하기 양말 스타일링 팁	엘르
시네마틱드라마 'SF8', '블링크' 한가람 감독 "인간과 인공지능의 케미에 집중...	엔터미디어
원주시 교통사고 입원환자 관리 실태 민관 합동 점검 실시	뉴스타운
[HD포토] 이시영, '아름다운 미소' (SF8 블링크)	톱스타뉴스
‘셀럽뷰티2’, 올인원 에센스 ‘쏠베라 아르베라 플러스’ 소개	더파워
'셀럽뷰티 시즌2', 민감피부 진정 위해 이시영, 아이돌 혜린이 선택한 '자극방...	제민일보
‘셀럽뷰티2’ 이시영, 혜린과도 찰떡 케미, 러블리 매력 폭발한 촬영장 비하...	글로벌이코노믹
'절친의 추억' 소유진 "시영아 정말 고마워♡" 이시영과 즐긴 정상의 절경	기호일보
이시영, 남편 조승현과 꼬마빌딩 매각…김성근 감독 '80억에 매입'	톱스타뉴스
이시영, 남편 조승현과 꼬마빌딩 매각…김성근 감독 '80억에 매입'	톱스타뉴스
[HD포토] 이시영, '컬크러쉬의 대명사' (SF8 블링크)	톱스타뉴스
[HD포토] 이시영, '여전한 방부제 미모' (SF8 만신)	톱스타뉴스
(여자)아이들, 참여지수 낮아졌지만 순위 방어 성공... 2020년 10월 걸그룹 브...	미래한국
BJ된 하니·로봇 이유영‥‘SF8’으로 상상하는 파격 미래(종합)	뉴스엔
[종합] 솔비, 김구라에 "결혼 축하해요…행복하세요?" ♥ 응원…김구라 "작작...	마이데일리
tvN ‘나는 살아있다’, 출연진들 캐릭터 포스터 공개	주간한국
'SF8' 한국형 '블랙미러' 탄생 기대…"시각적 스펙터클보다 철학적 사유" [MD...	마이데일리
원주시 교통사고 입원환자 관리 실태 민관 합동 점검	뉴스핌
'SF8' 8감독+16배우+MBC+웨이브, 초대형 韓 SF 탄생[종합]	스타뉴스
리뷰 | ‘SF8-블링크’, 클리셰 범벅에 한숨만 푹	맥스무비
[한국수의인물사전 61] 말과 경마 이야기 쓴 `이시영 수의사`	데일리벳
김구라, "결혼 축하해요" 농담에 머쓱…솔비 "세상 따뜻한 남자" [★SHOT!]	OSEN
[ST포토] 이시영, 절제된 섹시미	스포츠투데이
장흥군 용산면, ‘함께 생각하는’ 이장단 회의 개최	위키트리
'나는 살아있다' 김성령→(여자)아이들 우기, 생존 향한 포스터 공개	서울경제
"새로운 시도"..'SF8' 로봇 이유영→AI형사 하준, 시즌제로 이어질까[종합]	OSEN
[종합] "인공지능 형사·돌봄로봇이 있다면"…'SF8' 이유영→이연희 등이 그릴...	마이데일리
[HD포토] 이시영-한가람 감독-하준, '기대되는 액션물' (SF8 간호중)	톱스타뉴스
[KBS Joy] “셀럽뷰티2” 이시영, 탄탄한 몸매 비결과 동안피부 꿀팁 전한다	리서치페이퍼
`나는 살아있다` 7人 캐릭터 포스터 공개 "생존 넘어 성장"	매일경제
[KBS Joy] “셀럽뷰티2” 이시영, 탄탄한 몸매 비결과 동안피부 꿀팁 전한다	리서치페이퍼
셀럽뷰티2 이시영, ‘갈바닉 마사지기’로 피부 관리 방법 공개.. “3차 공구...	뉴스브라이트
김민경 '나는 살아있다' 합류…김성령ㆍ이시영 호흡 특전사 박은하 중사 노하...	비즈엔터
'운동하는 언니' 이시영 "#눈부시게 #예뻐 #그냥뭉클" 정상에서 만끽한 절경	기호일보
[TD포토] 이시영 '그림자도 완벽한 건강한 몸매'	티브이데일리
이시영, 건강미 넘치는 의상으로 '시선집중' (SF8 제작발표회)	스냅
[독립운동가 열전 <삶과 넋> 79] 조선식 노블레스 오블리주의 표상, 이석영	매일노동뉴스
문 대통령 "경제 반등 골든타임…소비쿠폰으로 마중물"	OBS
밀착 반바지·레깅스…현아·선미의 애슬레저룩 연출 TIP	머니투데이
'나는 살아있다' 김성령→우기, 캐릭터 포스터 공개..혹독한 생존기 예고	헤럴드POP
청산 못한 조선총독부 식민사관… 해방되지 못한 역사	경기신문
쏠베라 아르베라 플러스, KBS Joy 셀럽뷰티2에서 소개	환경일보
원주시, 교통사고 입원환자 관리 실태 민관 합동 점검 실시	신아일보
이시영 "'블링크' 하면서 AI에 대한 인식 바뀌었다"	티브이데일리
‘셀럽뷰티2’ 이시영·혜린 외출준비 한 번에 가능한 ‘올인원 에센스...	뉴스브라이트
[ST포토] 이시영 'AI 일상생활에서 놀라워'	스포츠투데이
김민경, '나는 살아있다' 합류…이시영·김성령과 호흡 [공식입장]	스포츠투데이
[ST포토] 포즈 취하는 이시영-한가람 감독-하준	스포츠투데이
이시영, 귀요미 아들과의 행복한 일상 공개 "아빠가 수확해온 블루베리..잼 만...	뉴스인사이드
‘셀럽뷰티2’ 이시영·혜린 외출준비 한 번에 가능한 ‘올인원 에센스...	뉴스브라이트
[ST포토] 이시영 'AI 일상생활에서 놀라워'	스포츠투데이
원주시, 교통사고 입원환자 관리 점검 시행	열린뉴스통신
김민경, '나는 살아있다' 합류…이시영·김성령과 호흡 [공식입장]	스포츠투데이
'나는 살아있다' 김성령·오정연→교관, 캐릭터 포스터 공개 "캐스팅 이유? 7...	마이데일리
[ST포토] 포즈 취하는 이시영-한가람 감독-하준	스포츠투데이
이시영, 귀요미 아들과의 행복한 일상 공개 "아빠가 수확해온 블루베리..잼 만...	뉴스인사이드
바이오톡 ‘3X 크로스링크 앰플’, 셀럽뷰티2서 여름 뷰티템으로 소개	이투데이
셀럽뷰티2, 이시영 혜린 피부 관리 이용한 '노니 수분 크림' 소개	뉴스브라이트
소병훈 "HUG 융자 이용한 유명가수, 연예인 부동산 투자 심각"	뉴스1
소병훈 "HUG 융자 이용한 유명가수, 연예인 부동산 투자 심각"	뉴스1
이시영 릴렉싱앰플, 캐시워크 돈버는퀴즈 추가 정답 업데이트	아시아뉴스통신
[피플] 유튜브 ‘낚낚’ 채널 진행자 이신영	낚시춘추
(여자)아이들 우기 ‘나는 살아있다’로 보여줄 매력 “기대감 충만”	뉴스엔
[포토]이시영-한가람-하준, '블링크'	아시아투데이
[포토]SF8, 수줍게 인사말하는 이시영	아시아투데이
'민낯 미인' 이시영 "큭"...호피 무늬 의상입고 셀피 한 컷	화이트페이퍼
'털털한 언니' 이시영 "오늘 새벽 출근. 해가 길어져서 새벽인데도 이렇게 밝...	기호일보
왕산 허위선생 순국 112주기 추모제 봉행	매일일보
원주시, 교통사고 입원환자 관리 실태 민관 합동 점검 실시	경인매일
