갓세븐 영재 측 "'학폭 주장' 당사자 만났지만 근거 제시 못해"	연합뉴스
與 '尹 라인 도표' 제시에 윤석열 "'1987' 영화가 생각나...라인 뭔지 몰라"	서울경제언론사 선정
GE헬스케어, 뉴노멀시대의 '원격 모니터링' 비전 제시	헬스조선
'식스센스' 제시 닮은 사장님 등장→전소민, 눈물 글썽 '무슨 일?'	텐아시아
이낙연 "징용 협의 타결 기대"에 日 "韓이 해결책 제시해야"	뉴시스
CJ대한통운 수장의 사죄...택배노동자 보호 종합대책 제시	한국경제TV
이재명, '경제통' 유승민 저격…"전문가답게 대안 제시하라"	한국경제언론사 선정
JYP "갓세븐 영재 학폭 주장 글쓴이, 어떤 근거도 제시 못 해"	노컷뉴스
DB손보, 교통·환경 문제 해법 제시한 소셜벤처 지원…성과 공유	MTN
오세훈 "부동산 해법 제시할 수 있다"…사실상 대선출마 선언	중앙일보
전재수 의원이 제시한 카톡 내용	뉴시스
DB손보, 교통·환경 문제 해법 제시한 소셜벤처 지원…성과 공유	MTN
토니모리, 제시와 함께한 속눈썹 부캐 컬렉션 화보 공개	데일리그리드
오세훈 "부동산 해법 제시할 수 있다"…사실상 대선출마 선언	중앙일보
소하천 녹조문제 해결위해 통합적 물관리시스템 제시	대전일보
현대차 '2020 한국IR 대상' 수상...적극 미래 경영전략 제시 등 호평	파이낸셜뉴스
산림작업로 시설기준 제시	환경일보
JYP “영재 학폭 주장 당사자 만났지만 근거 제시 못했다”	민중의소리
한국 예술인 고용보험 제도, 유네스코통해 전세계 비전 제시	경인매일
환불원정대 이효리X엄정화X제시X화사, 무기 챙겨 출격 '돈 터치 미'	뉴스컬처
태국 시위대 "총리, 사흘 내 퇴진"…시한 제시(종합)	뉴스1
성균관대 전영준 교수, 세계 최초 폐암 환자 맞춤형 방사선 표적치료 가능성 ...	전자신문
양산乙 김두관 "국토부, 김해신공항 안(案) 명확한 답 제시하라"	프레시안
카드 산업의 미래 제시? 지문 인증 통해 결제하는 신용카드	보안뉴스
조명래 장관 "제주형 뉴딜, 탄소중립 이정표 제시"	헤드라인제주
"투자해법·리스크관리 방안 제시"…신한금투, 신나고 금융시장 포럼 개최	청년일보
‘2020 인천리빙디자인페어’ 개막… “포스트 코로나 시대 맞아 새로운 집의...	동아일보
[국감2020] 與인물관계도 제시에 윤석열 "영화 1987 생각나"	데일리안
영주시, 제11회 영주농업대상 ‘선발영주농업의 새로운 비전을 제시하다’	브릿지경제
SK이노베이션, '화재 없는 배터리' 강조…'넥스트 배터리' 방향제시	뉴시스
'글로벌 핫이슈, 2021 화장품 시장 이슈와 전망 컨퍼런스'개최된다…글로벌 화...	경상일보
"돈 터치 미"...제시, 파격 의상도 완벽 소화	YTN
SK이노, 인터배터리2020서 미래방향 제시	이투뉴스
김정재 의원 “재생에너지 3020 같은 목표만 제시말고 사업개시 장애요소 해결...	뉴데일리
"비용분담 기준 제시"…공정위, `하도급 금형 모범거래 가이드라인` 제정	디지털타임스
성균관대 전영준 교수, 세계 최초 폐암 환자 맞춤형 방사선 표적치료 가능성...	베리타스알파
박근희 "CJ대한통운, 과로사 해결 위해 분류작업 개선책 22일 제시"	비즈니스포스트
박홍근 의원, ‘줄줄새는 보조금’ 환수방안 제시	환경미디어
"광주시가 다른 지방정부에 탄소중립 이정표를 제시"	전남일보
삼성SDI, '인터배터리 2020' 참가…"배터리 미래 제시"	이데일리
"뉴노멀시대 학회표준 제시 자부심‥산업화 직결 토대 마련 보람"	메디파나뉴스
HongLee Company, 유럽시장 내 새로운 아트페어 패러다임 제시	르몽드
치솟는 서울 집값, 3기 신도시는 수년 뒤… 의정부∙파주∙하남 대안 제시	동아일보
세종청년주간 행사 성료…비대면 축제 모델 제시	충청일보
박범계 의원 제시한 옵티머스 수사관련 자료 바라보는 검찰총장	노컷뉴스
강남세브란스병원 침샘종양 클리닉, 침샘암 맞춤형 치료 방안 제시	스포츠조선
은비로·제시로…방송가 싹쓸이	스포츠동아
‘뉴노멀’ 시대, 교회의 질적 성장 모델 제시	국민일보
반월상 연골판 후각 부착부 낮은 치유능력 대한 미세조직학적 근거 제시됐다	메디컬투데이
서초구, 양재·우면동 일대 300만㎡ 개발 청사진 제시	헤럴드경제
'대한민국 수소 경제 선도 충남' 미래 비전 제시	매일일보
"정부 경제전망, 의지 아닌 근거 기반으로 제시돼야" 국책硏의 일침	아시아경제언론사 선정
아산시의회 제225회 임시회 마무리···시정질의 통해 다양한 대책방안 제시	브릿지경제
"우버, 경쟁사인 프리나우 인수에 1억유로 제시"	뉴스핌
SKT, '누구' 콘퍼런스 개최…"AI 미래상 제시"	연합뉴스
이낙연 "당내 신복지체계 연구팀 발족…지속가능 모델 제시할 것"	뉴스1
채용 때 신체 조건 제시 금지… 고용평등법 각의 의결	국민일보
홍남기-김현미, 전세 안정화 두고 온도차…내주 대책 제시	브릿지경제
동구, '공공미술 프로젝트' 사업 방향 제시한다	전남일보
[★포토]제시, 분위기 미녀로 변신…완벽한 S라인	스포츠서울
[단독]양향자 "역차별", '3%룰' 보완책 제시…'합산→개별, 1년 의무보유'	아시아경제언론사 선정
과기부, 국제병원의료산업박람회서 '디지털헬스케어' 미래 방향 제시	뉴시스
서울대병원‘의료발전위원회 제2기’출범…의료계 전략과제 제시	메디컬월드뉴스
GE헬스케어, 뉴 노멀시대의 원격 모니터링의 현재와 지속가능한 비전 제시	헬스인뉴스
SK이노베이션 '넥스트 베터리 방향 제시'	뉴스1
공인모, 2021년 공인중개사 무료인강 및 시험 합격 장학금 프로모션 제시	뉴스케이프
코로나시대 지방정부 혁신 방향 제시 '2020 의정부포럼' 개최	뉴시스
‘정희’ 크러쉬 “듀엣하고 싶은 소속사 가수? 제시, 가장 친해”	뉴스엔
조명래 장관 “광주시, 탄소중립 이정표 제시”	브레이크뉴스
조광한 남양주시장 “쓰레기감량 표준모델 제시하자”	파이낸셜뉴스
제시, 가슴 절개 노출룩 자신감 "돈 터치 미"	여성조선
김봉현 전 회장 관련 자료제시하는 장제원	뉴시스
'포스트 코로나' 시대에 새로운 집의 역할 제시...2020 인천리빙디자인페어	뉴스프리존
수경원 연구과제 수산현안 해소 방향성 제시	어업IN수산
채용때 남녀 신체ㆍ미혼 조건 제시 못한다…임신 중 육아휴직도 가능	중앙일보
‘인천 라면 형제’ 재발 방지 아동학대 개선책 제시	파이낸셜뉴스언론사 선정
이용섭 시장 행정통합 논의 절차 제시…'용역 후 시·도민 결정'	연합뉴스
[IT오늘] KT, 디지털 전환 화두 제시 '디지털-X 서밋' 개최…LG유플러스, '대...	시사오늘
'트롯신2' 김연자, 완벽한 무대 위해 식단 제시.."한우 먹을 것"	헤럴드POP
김희국 의원, 청년임대주택 조성원가 낮추는 방안 서울시에 제시	경북일보
국내 배터리3사 ‘인터배터리’ 총출동…“차세대 배터리 방향 제시”	SBS CNBC
[2020 대전세종 정책엑스포] 코로나가 불러온 사회변화… 다양한 시선에서 방...	충청투데이
2020 로보월드, 4차 산업혁명 핵심기술 및 미래 비전 제시한다	산업일보
제시, 파격 의상과 함께 "Don't touch me"	아시아경제
이근, 스카이다이빙협회 공문 제시 "故 정인아 사고 현장에 이근 없었다"	브릿지경제
감사원 “월성 1호기 폐쇄 타당성 판단 한계"…절충안 제시	헤럴드경제
'부양책 시한 제시' 펠로시, 므누신 통화 앞두고 "이견"	뉴시스
‘2020 의정부포럼’…포스트 코로나 시대 지방정부 혁신방향 청사진 제시	헤럴드경제
[헤럴드디자인포럼 2020] “디자인이 곧 국가 경쟁력” “삶의 질 향상 위한 ...	헤럴드경제
신세계百, 숙면 공간 솔루션 제시! 침실 꾸미는 법 알려준다	메트로신문
[집중진단] 시급한 전세대책…“새로운 접근” 제시한 이낙연	SBS CNBC
[종합]"나훈아 피처링 원해"..'정희' 크러쉬가 전한 #태연 #제시 #with HER	헤럴드POP
내맘대로 보는 스포츠 중계…삼성, 새로운 5G 시청 경험 제시	뉴스토마토
WCG 서태건 대표 “e스포츠 새 방향 제시하는 존재 되겠다”	국민일보
[좋은정보의 '황맥기'] 10/16 제시 '이노와이어리스' 수익률 +5.7%! 오늘의 '...	MTN
수학싸부 차길영 원장, 학원ㆍ공부방ㆍ교습소 미래형 모델 제시	스타데일리뉴스
선진 2025년 글로벌 매출 30억 달러 제시…비전선포식 진행	쿠키뉴스
제시, '가슴골 활짝' 파격 노출 의상 "돈 터치 미"	스포츠한국
이근 대위 "스카이다이빙 사망사고 때 난 없었다"…증거 공문 제시	머니투데이
IT솔루션 기업 ‘인젠트’, ISS 2020 LIVE 를 통해 기술 트렌드 제시	서울경제
"우버, 경쟁사인 프리나우 인수에 1억유로 제시"	뉴스핌
SKT, '누구' 콘퍼런스 개최…"AI 미래상 제시"	연합뉴스
이낙연 "당내 신복지체계 연구팀 발족…지속가능 모델 제시할 것"	뉴스1
세종청년주간 행사 성료…비대면 축제 모델 제시	뉴스렙
채용 때 신체 조건 제시 금지… 고용평등법 각의 의결	국민일보
삼성SDI, ‘인터배터리 2020’ 참가…친환경 미래상 제시	뉴스웨이
현대차, 2020 '한국IR대상'… "미래 경영전략 제시 인정"	매일일보
SK이노, '인터배터리2020' 참가...배터리 차별화 제시	뉴스핌
“광주시가 탄소중립 이정표 제시”	광주매일신문
홍남기-김현미, 전세 안정화 두고 온도차…내주 대책 제시	브릿지경제
홍남기-김현미, 전세 안정화 두고 온도차…내주 대책 제시	브릿지경제
동구, '공공미술 프로젝트' 사업 방향 제시한다	전남일보
[★포토]제시, 분위기 미녀로 변신…완벽한 S라인	스포츠서울
[단독]양향자 "역차별", '3%룰' 보완책 제시…'합산→개별, 1년 의무보유'	아시아경제언론사 선정
과기부, 국제병원의료산업박람회서 '디지털헬스케어' 미래 방향 제시	뉴시스
서울대병원‘의료발전위원회 제2기’출범…의료계 전략과제 제시	메디컬월드뉴스
GE헬스케어, 뉴 노멀시대의 원격 모니터링의 현재와 지속가능한 비전 제시	헬스인뉴스
삼성SDI, `인터배터리 2020`에서 배터리 기술 미래 비전 제시	디지털타임스
제시, 파격적인 노출 의상 카리스마..."돈 터치 미"	뉴시스
“광주시, 지방정부 탄소중립 이정표 제시”	전남매일
SK이노베이션 '넥스트 베터리 방향 제시'	뉴스1
공인모, 2021년 공인중개사 무료인강 및 시험 합격 장학금 프로모션 제시	뉴스케이프
코로나시대 지방정부 혁신 방향 제시 '2020 의정부포럼' 개최	뉴시스
SK이노베이션, 인터배터리 2020서 '넥스트 배터리' 방향 제시	데이터뉴스
침샘암 조직학ㆍ악성도에 따른 맞춤형 치료 방안 제시	메디소비자뉴스
삼성SDI, 인터배터리 전시회에 참여해 기술과 친환경 미래상 제시	비즈니스포스트
과기정통부, 디지털건강관리 미래 방향 제시	뉴스렙
‘정희’ 크러쉬 “듀엣하고 싶은 소속사 가수? 제시, 가장 친해”	뉴스엔
현대차, 2020 '한국IR대상' 대상 수상…적극적인 미래 경영전략 제시 및 투자...	스포츠조선
조명래 장관 “광주시, 탄소중립 이정표 제시”	브레이크뉴스
GE헬스케어, 뉴 노멀시대 원격 모니터링 비전 제시	아시아투데이
SK이노, 산자부 주최 인터배터리 2020에서 '넥스트 배터리' 방향 제시	한국금융신문
"광주광역시가 다른 지방정부에 탄소중립 이정표를 제시했다"	위클리오늘
조광한 남양주시장 “쓰레기감량 표준모델 제시하자”	파이낸셜뉴스
이재명 "유승민, 맹목적 비난 말고 전문가다운 대안 좀 제시하라"	굿모닝충청
제시, 가슴 절개 노출룩 자신감 "돈 터치 미"	여성조선
김봉현 전 회장 관련 자료제시하는 장제원	뉴시스
'포스트 코로나' 시대에 새로운 집의 역할 제시...2020 인천리빙디자인페어	뉴스프리존
수경원 연구과제 수산현안 해소 방향성 제시	어업IN수산
강남세브란스병원, 침샘암 맞춤형 치료 방안 제시	보건뉴스
김봉현 전 회장 관련 자료제시하는 장제원	뉴시스
SK이노, 인터배터리서 '넥스트 배터리' 방향 제시	한국정책신문
강남세브란스병원, 침샘암 맞춤형 치료 방안 제시	보건뉴스
삼성SDI, 배터리기술의 미래비전 제시한다	업다운뉴스
갓세븐 측 "영재 학폭 주장 A씨, 근거 제시 못해…추가 루머 법적대응" [전문...	티브이데일리
채용때 남녀 신체ㆍ미혼 조건 제시 못한다…임신 중 육아휴직도 가능	중앙일보
조명래 환경부 장관 "광주시가 탄소중립 이정표 제시"	남도일보
‘인천 라면 형제’ 재발 방지 아동학대 개선책 제시	파이낸셜뉴스언론사 선정
이용섭 시장 행정통합 논의 절차 제시…'용역 후 시·도민 결정'	연합뉴스
[IT오늘] KT, 디지털 전환 화두 제시 '디지털-X 서밋' 개최…LG유플러스, '대...	시사오늘
‘인천 라면 형제’ 재발 방지 아동학대 개선책 제시	파이낸셜뉴스언론사 선정
이용섭 시장 행정통합 논의 절차 제시…'용역 후 시·도민 결정'	연합뉴스
SK이노, '인터배터리 2020'서 넥스트 배터리 제시	현대경제신문
[IT오늘] KT, 디지털 전환 화두 제시 '디지털-X 서밋' 개최…LG유플러스, '대...	시사오늘
강남세브란스 침샘종양 클리닉, 침샘암 맞춤형 치료 방안 제시	이데일리
'트롯신2' 김연자, 완벽한 무대 위해 식단 제시.."한우 먹을 것"	헤럴드POP
김희국 의원, 청년임대주택 조성원가 낮추는 방안 서울시에 제시	경북일보
국내 배터리3사 ‘인터배터리’ 총출동…“차세대 배터리 방향 제시”	SBS CNBC
[2020 대전세종 정책엑스포] 코로나가 불러온 사회변화… 다양한 시선에서 방...	충청투데이
토니모리, 쇼킹카라 모델 제시의 1인 7색 부캐 컬렉션 #제시마스카라 화보 공...	뉴스포인트
토니모리, 쇼킹카라 모델 제시의 1인 7색 부캐 컬렉션 #제시마스카라 화보 공...	뉴스포인트
2020 로보월드, 4차 산업혁명 핵심기술 및 미래 비전 제시한다	산업일보
제시, 파격 의상과 함께 "Don't touch me"	아시아경제
이근, 스카이다이빙협회 공문 제시 "故 정인아 사고 현장에 이근 없었다"	브릿지경제
감사원 “월성 1호기 폐쇄 타당성 판단 한계"…절충안 제시	헤럴드경제
'부양책 시한 제시' 펠로시, 므누신 통화 앞두고 "이견"	뉴시스
‘2020 의정부포럼’…포스트 코로나 시대 지방정부 혁신방향 청사진 제시	헤럴드경제
[헤럴드디자인포럼 2020] “디자인이 곧 국가 경쟁력” “삶의 질 향상 위한 ...	헤럴드경제
신세계百, 숙면 공간 솔루션 제시! 침실 꾸미는 법 알려준다	메트로신문
조명래 환경부 장관, 탄소중립 이정표제시~이용섭 광주시장에 감사 서한 보내	위키트리
'오늘과 다른 미래 꿈꾼다' 삼성SDI, 인터배터리서 배터리 기술 미래 비전 제...	오토데일리
SK이노베이션, 인터배터리서 '넥스트 배터리' 방향 제시	디지틀조선TV
과기정통부, 디지털건강관리의 미래 방향을 제시한다	위클리오늘
[집중진단] 시급한 전세대책…“새로운 접근” 제시한 이낙연	SBS CNBC
[종합]"나훈아 피처링 원해"..'정희' 크러쉬가 전한 #태연 #제시 #with HER	헤럴드POP
내맘대로 보는 스포츠 중계…삼성, 새로운 5G 시청 경험 제시	뉴스토마토
WCG 서태건 대표 “e스포츠 새 방향 제시하는 존재 되겠다”	국민일보
[좋은정보의 '황맥기'] 10/16 제시 '이노와이어리스' 수익률 +5.7%! 오늘의 '...	MTN
'속눈썹 메이크업만 바뀌어도' 본캐와 부캐 넘나드는 제시의 팔색조 매력	그라피
수학싸부 차길영 원장, 학원ㆍ공부방ㆍ교습소 미래형 모델 제시	스타데일리뉴스
수학싸부 차길영 원장, 학원ㆍ공부방ㆍ교습소 미래형 모델 제시	스타데일리뉴스
선진 2025년 글로벌 매출 30억 달러 제시…비전선포식 진행	쿠키뉴스
제시, '가슴골 활짝' 파격 노출 의상 "돈 터치 미"	스포츠한국
이근 대위 "스카이다이빙 사망사고 때 난 없었다"…증거 공문 제시	머니투데이
'포스트 코로나' 시대에 새로운 집의 역할을 제시하다…2020 인천리빙디자인페...	베타뉴스
IT솔루션 기업 ‘인젠트’, ISS 2020 LIVE 를 통해 기술 트렌드 제시	서울경제
김태년 민주당 원내대표 "야당에 제시한 시한 1주 남아"	내일신문
강남세브란스병원, 침샘암 맞춤형 치료 방안 제시	라포르시안
SK이노베이션, '넥스트 배터리' 방향 제시한다	지앤이타임즈
[SW포토]잘했어 제시 고반	스포츠월드
온택트 강경젓갈축제, 코로나 시대 모범 축제모델 제시	중도일보
과기정통부, 병원의료박람회 참가…디지털헬스케어 방향 제시	뉴스토마토
SKT, 20일 '누구 콘퍼런스' 개최…AI 서비스 미래상 제시	브릿지경제
재생에너지원 발굴-스마트그린산단 공급 방안 제시	새전북신문
정의선 회장 "인류에 한차원 높은 이동경험 제시"	서울경제언론사 선정
제시, 토니모리 쇼킹카라 모델 발탁…'부캐 컬렉션' 화보 공개	싱글리스트
SK이노베이션, '인터배터리(InterBattery) 2020'에서 '넥스트 배터리'의 방향...	미디어리퍼블릭
봉화군, 평생학습도시 발전 비전 제시	경상매일신문
환불원정대 이효리X엄정화X화사X제시, 첫 화보+앨범 재킷 동시 촬영	뉴스컬처
제시, 파격 가슴 절개 노출 의상 입고 "Don't touch me"	스포츠조선
제시, 파격 가슴 절개 노출 의상 입고 "Don't touch me"	스포츠조선
SKT, ‘누구 컨퍼런스’에서 AI 서비스의 미래 제시한다	이코노믹리뷰
온라인 강경젓갈축제 조회수 130만회… 성공적 모델 제시	뉴스1
수학싸부, 학원 공부방 교습소 미래형 모델 제시	NSP통신
이주희 광명시의원 "포스트코로나 시대 자치분권 정책대안 제시"	뉴스핌
강남세브란스병원 침샘종양 클리닉, 침샘암 맞춤형 치료 방안 제시	헬스인뉴스
끊이지 않는 지입제 택배 사고에 일자리위원회, 직고용 쿠친 '모범사례' 제시	스포츠서울
‘고객·인류·미래·나눔’ 4대 키워드 제시한 정의선	동아일보언론사 선정
"기가 막힌다"..'정희' 예지, 제시도 울고갈 폭풍 랩+스웨그	OSEN
육감 몸매 드러낸 제시 "돈 터치 미"	한국경제TV
육감 몸매 드러낸 제시 "돈 터치 미"	한국경제TV
굿프렌드, 집콕족들을 위한 운동 ‘밸런스코어 요즘것들 훌라후프’ 제시	더퍼블릭
김희국 의원, 서울 청년임대주택 문제 대안 제시	경상매일신문
제시, 파격 가슴 절개 의상→노출 제로…그래도 섹시한 은비 [★SHOT!]	OSEN
홈즈컴퍼니,지역불균형 대안으로 홈즈타운 제시	한국경제
광주시, 다른 지방정부에 탄소중립 이정표 제시	내외뉴스통신
[국감인물] 임종성 더불어민주당 의원, 현안 사전조사·검토로 대안 제시 '정...	중부일보
이만희 의원, 해운업 재건 위한 해운금융 활성화 대안제시	뉴스렙
서태건 WCG 대표 “발전하는 e스포츠, 새 방향 제시하겠다”	국민일보
전영준 성균관대 교수, 폐암 환자 맞춤형 방사선 표적치료 가능성 제시	메트로신문
비트만바텐필드, 사출성형 스마트팩토리 위한 최적의 대안 제시	월간로봇기술
제시, 니트원피스로 뽐낸 글래머 몸매	매일경제
제시, 강렬한 비주얼	서울경제
제시, 부드러운 시선	서울경제
[SR경제&라이프] SK이노, '안전·충전속도·주행거리' 차세대 배터리 방향성 ...	SR타임스
포항상의, 찾아가는 FTA활용교육…지역 수출기업 FTA 활용방안 제시	뉴스웍스
'환불원정대' 엄정화·이효리·제시·화사, 눈빛+실루엣 만으로 강렬한 아우라	디지틀조선일보
펠로시, 美대선 전 부양책 협상 시한 '48시간' 제시	뉴시스
[SW포토]3점슛 성공시킨 삼성 제시 고반	스포츠월드
한의사의 리도카인 사용, 소비자에 주어질 이익 설득력 있게 제시해야	한의신문
경남도 '동남권 특별연합' 밑그림 제시	경남도민일보
'리테일의 달인'이 제시하는 패스트 패션의 새로운 패러다임	더퍼스트
JYP, 갓세븐 영재 '학폭' 주장 글쓴이 만났다 "근거 제시 못해" [공식입장]	스포츠투데이
'온택트 강경젓갈축제', 130만 조회 성공모델 제시	TJB 대전방송
[[김삼웅의 인물열전] 다시 찾는 다산 정약용 평전] 국가제도와 운영방략 제시...	오마이뉴스
'해양레저 비전 제시'…1회 제주 국제해양레저박람회 폐막	뉴시스
제시, 미소 짓는 '은비'	서울경제
제시, 명치까지 파인 과감 노출 “돈 터치 미”	세계일보
트럼프 "민주당이 제시한 것보다 큰 코로나 부양책 원해"	뉴스핌
이재명, ‘대통령 경제포기’ 비판한 유승민에 “전문가다운 대안 제시해주길...	이투데이
'직상장' 앞둔 교촌, 사업 지속 동력으로 '국내·외 가맹점' 확대 제시	녹색경제신문
토니모리 '쇼킹카라' 모델 제시 발탁	아시아투데이
블랙핑크vs박진영vs제시, '인기가요' 1위 대결	일간스포츠
【환경】'기후변화 대응 목표 제시한다' 당진시, 지역 맞춤형 연구 시작	sbn뉴스
제시, 비니로 뽐낸 패션 센스	서울경제
강철우 경남도의원, 도의회 파행, 문제점과 해결방안 제시	뉴스프리존
[좋은정보의 '황맥기'] 어제 제시한 '이엔드디' +10.9%! 오늘의 '황맥기' 종목...	MTN
대한민국에 희망을 제시하는 '차세대 리더 100인'	시사저널언론사 선정
과기정통부, 디지털건강관리의 미래 방향을 제시한다	위클리오늘
SKT, '누구 컨퍼런스 2020' 개최... "AI 서비스 미래 제시"	시장경제신문
[뿌리깊은 한일 갈등] ②日스가, 조건부 방한 제시...한중일 정상회의 연내 개...	아주경제
빅히트 급락 쇼크?...새내기주 43개 목표가 제시는 7개뿐	서울경제언론사 선정
이만희 의원, 해운업 재건 위한 해운금융 활성화 대안제시	위클리오늘
강남세브란스병원, 침샘종양 클리닉, 침샘암 맞춤형 치료 방안 제시	후생신보
삼성SDI, ‘인터배터리’서 친환경 배터리 기술 미래 제시	이투데이
제시 '환불원정대'로 데뷔	서울경제
[사진]이관희-제시 고반, '좋았어'	OSEN
힘쓰는 제시 보고 달려오는 지미유	서울경제
제시, 니트 원피스로 드러낸 '육감적 볼륨 몸매'…韓의 킴 카다시안	스포츠조선
감정원, 부동산통계 신뢰성 제고 방안으로 '표본확대' 제시	프라임경제
감정원, 부동산통계 신뢰성 제고 방안으로 '표본확대' 제시	프라임경제
김종철 대표 "정부·경남도, 중소조선소 살리는 방안 제시해야"	노컷뉴스
침샘암 치료 결과, 악성도 따라 분석…침샘암 맞춤형 치료 방안 제시	메디컬월드뉴스
제시, 도발적인 섹시자태 '볼륨감 끝판왕'	enews24
SK이노베이션, 인터배터리 2020서 '넥스트 배터리' 방향 제시	울산매일신문
성균관대 융합생명공학과 전영준 교수, 세계 최초 폐암 환자 맞춤형 방사선 표...	유교신문
[Btv 인천뉴스] '라면형제' 한 달…아동학대 방지 개선책 제시	SK브로드밴드
'걸크러시' 제시, 파격 가슴 절개 의상으로 '시선강탈'[★SNS]	스포츠서울
조석호 의원, '사회적 가치' 실현 '선진국의 척도'...방향과 내용 제시	뉴스워커
‘놀면 뭐하니’ 환불원정대 엄정화X이효리X제시X화사 파워..2주 연속 화제성...	OSEN
청양군, 청양고추 산업화 혁신안 제시	중도일보
레드햇 포럼 APAC 2020, 오픈 하이브리드 클라우드 비전 제시	데일리시큐
[포토]제시, 알고보면 귀요미	헤럴드POP
'인기가요' 박진영vs제시vs블랙핑크, 1위 대결	스타뉴스
민주당 '정책통'이 제시한 미디어 위기 해법	미디어스
제시, 파격 가슴 노출 의상 소화..."돈 터치 미"	조이뉴스24
온택트 강경젓갈축제 조회수 130만 기록…코로나시대 축제모델 제시	뉴스핌
제시, 올블랙에 비니로 스타일 마무리!	서울경제
[포토]제시, 촬영 전 의상체크	헤럴드POP
'놀면 뭐하니?' 유재석, 제시 무대 의상 입고 '돈벌레' 변신…폭소	뉴스1
이용섭 시장 행정통합 논의 구체적 절차 제시	광주매일신문
[사진]삼성 제시 고반, '3점슛 세리머니'	OSEN
조명래 환경부 장관, 이용섭 광주시장에 감사 서한… 탄소중립 이정표 제시	머니S
제시, 감출 수 없는 콜라병 몸매…일상도 환불원정대 포스	마이데일리
신민호 도의원, '청년 살기 좋은 전남' 정책 제시	전남일보
옵티머스 수사 자료 제시하는 유상범 의원	연합뉴스
'인기가요' 박진영vs제시vs블랙핑크, 1위 맞대결	엑스포츠뉴스
청양군 '고추산업 발전 위한 혁신모델' 제시	중부매일
SKT, 누구 콘퍼런스 2020 연다...‘AI 누구 미래상’ 제시	인더뉴스
[포토]제시, 오늘은 비니가 포인트	헤럴드POP
[포토]제시, 오늘은 비니가 포인트	헤럴드POP
제시, 대문자 S라인 자태..밀착 원피스로 뽐낸 압도적 몸매	헤럴드POP
[포토]제시, 선글라스 속 순둥미소	헤럴드POP
[포토]제시, 다같이 '눈누난나'	헤럴드POP
[포토]제시, 멀리서도 걸크러쉬 뿜뿜	헤럴드POP
[사진]제시 고반, '3점슛 찬스 놓치지 않고'	OSEN
글로벌 컨설팅 업체 ‘알릭스파트너스’, 포스트코로나 시대 IT 기업 생존전략...	글로벌메이커스
[단독] 한국지엠, 성과급 180만원 추가 제시…부평공장에 2150억원 투자	아시아타임즈
고양이 분양샵 '가필드고양이' 합리적인 분양가 제시	데일리시큐
제시, 어깨+가슴선 드러낸 파격 클리비지룩…"카리스마"	머니투데이
제시, 어깨+가슴선 드러낸 파격 클리비지룩…"카리스마"	머니투데이
[포토]이효리-제시, 천옥과 은비	헤럴드POP
김봉현 사건 관련자료 제시한 장제원 의원	노컷뉴스
[포토]제시, 이런건 은비가 할게요!	헤럴드POP
‘인기가요’ 박진영vs제시vs블랙핑크, 1위 후보 대격돌	뉴스엔
제시vs모델, 아찔한 '클리비지 룩'…어디 제품?	머니투데이
[국감인물] 더불어민주당 김영진, 현안에 대한 날카로운 질의·대안 제시로 호...	중부일보
美 "종전선언, 테이블에"…협상 재개 시점도 제시	OBS
제시, 독보적 볼륨 몸매…우아美까지 완벽 소화 [★해시태그]	엑스포츠뉴스
옵티머스 자료 제시한 유상범 의원	노컷뉴스
옵티머스 자료 제시한 유상범 의원	노컷뉴스
'독감백신 접종 후 사망'과 관련해 한 전문가가 무시무시한 의견을 제시했다	위키트리
13명의 청춘이 이 시대의 청춘에게... 세븐틴이 제시할 "멈춤의 용기"	문화뉴스
KAIST, 딥러닝 정확도•속도 향상 기술 개발....배치 선택 새 접근법 제시	워크투데이
완 비사카, 제시 린가드 전 여친과 '바람' 들통... 현 여친은 '임신 중'	엑스포츠뉴스
오늘은 은비 아니고 제시, 완벽 S라인 몸매 ‘시선 강탈’ [SNS★컷]	뉴스엔
갓세븐 영재 측 "'학폭 피해' 주장자, 어떤 근거도 제시 못해…허위사실 법적...	싱글리스트
IBM "실적 전망치 제시 않기로"…시간외서 3% 가까이 하락	연합인포맥스
세계적 문화도시로 변모 성공사례, 미래 한국사회 비전 제시한다	동아일보
제시, 파격적 노출 의상 입고 매력발산 '걸크러쉬 폭발'	MBN
제시, 파격적 노출 의상 입고 매력발산 '걸크러쉬 폭발'	MBN
크래머 "미 정부 구글 조사…강력 매수 제시 이유"	연합인포맥스
청양군, 고추산업 발전 위한 혁신모델 제시	충남일보
[국감브리핑]“산지태양광-산사태 관련 산림청 엉터리 통계 제시”	강원일보언론사 선정
몸에서 떨어지지 않는 굿프렌드 '밸런스코어 스마트 훌라후프' 새로운 운동 방...	테크월드
SKT, '누구 컨퍼런스' 언택트 개최...AI 미래상 제시	글로벌이코노믹
박범계 의원, 옵티머스 관련 자료 제시	노컷뉴스
송형일 의원, '전문성 돋보인' 광주시 하수도 하천 개선 대안 제시 '주목'	이뉴스투데이
“종교 자유 보장 법률안 제시하자”	국민일보
'원희룡 모델' 제시한 원희룡, 대권 도전 공식화…"중도·보수 하나 되자"	데일리안언론사 선정
'인기가요' 박진영vs제시vs블랙핑크, 10월 셋째 주 1위 트로피 두고 경쟁	헤럴드POP
조석호 의원, '사회적 가치' 실현의 구체적 방향 제시	열린뉴스통신
홈즈컴퍼니, 지역 불균형 대안으로 스마트 코빌리지 `홈즈타운` 제시	매일경제
"노벨경제학상 경매이론, 이동통신 발전 근간 제시"	아시아경제언론사 선정
의령군, 미래농업 비전 제시	브릿지경제
[포토]이효리-제시, '돈 터치 미' 무대 기대해주세요	헤럴드POP
[포토]제시, 환불원정대 첫 무대 기대해주세요!	헤럴드POP
구글 클라우드-세아그룹, 협업으로 디지털 트랜스포메이션 전략 제시	한국금융신문
김태년 “라임·옵티머스 카더라 통신 수준…근거 제시해야”	국민일보언론사 선정
이근, 성추행 해명 '찜찜'..'제시의 쇼!터뷰' 호신술 새삼 화제	이데일리언론사 선정
청양군, 고추산업 발전 혁신모델 제시	대전투데이
"비트코인, 대세 상승 시작됐다."…글로벌 전문가들이 제시한 3가지 비트코인...	이코노뉴스
제시, 가슴 깊게 절개된 파격 의상.."만지지 마" 카리스마	스타뉴스
"돈터치미" 제시, 파격 의상도 완벽 소화…환불원정대 카리스마 [★해시태그]	엑스포츠뉴스
'컴백' 던(DAWN), '던디리던 (Feat. 제시)' 안무 연습 영상 공개	한국경제
인천시, GTX-D 영종행·김포행 노선 동시 추진…최적방안 제시	연합뉴스
[포토]제시, 오늘 '환불원정대+던 무대'로 바쁜 하루	헤럴드POP
‘놀면 뭐하니?’ 환불원정대 의상 바꿔 입기 현장 포착! 유재석, 제시 옷 강...	MBC연예
제시, 볼륨 보디 돋보이는 파격 패션…걸크러시 매력 폭발 [데일리SHOT]	마이데일리
팀 쿡 CEO "아이폰 새 시대 연다"…빠르고 똑똑한 혁신 제시한 '아이폰12'	IT조선
제시, 볼륨 보디 돋보이는 파격 패션…걸크러시 매력 폭발 [데일리SHOT]	마이데일리
팀 쿡 CEO "아이폰 새 시대 연다"…빠르고 똑똑한 혁신 제시한 '아이폰12'	IT조선
제시, 가슴 절개 노출 의상 입고 ‘범접불가’ 몸매	매일경제
[국감]김봉현 전 회장 관련 자료 제시하는 장제원 의원	뉴스1
'식스센스' PD "마지막 녹화, 유재석 '알럽 제시' 인사에 제시 눈물" [인터뷰...	이데일리
이근x김용호 공문서 격돌, 스카이다이빙 사망사고 둘러싸고 증거물 제시 	한국면세뉴스
유상범 의원 제시 옵티머스 관련 자료 보는 여당의원들	노컷뉴스
제1회 세계문화산업포럼 28일 대구서 개최…"음악과 엔터산업의 미래 제시"	매일경제
던(DAWN), 미니 1집 ‘던디리던’ 인터뷰 영상 공개 “싸이·제시·크러쉬 등...	한국경제TV
'놀면 뭐하니?' 유재석, 제시 '눈누난나' 의상에 충격 "돈 벌레 같아" [포인트...	엑스포츠뉴스
[DAY컷] 제시·화사·정재형, ‘음악중심’ 비하인드 공개 “환불원정대♥”	스포츠동아
현대차 회장 취임한 정의선, 그룹 혁신 지향점으로 "고객·인류·미래·나눔"...	스포츠조선
채리나 "이효리, 핑클 때부터 눈에 띄어…제시도 만나고파"	뉴시스
英 매체, 판 다이크 대체자로 3명 제시...'카박-화이트-뤼디거'	스포탈코리아
“난 뭐든 입겠어”…환불원정대 엄정화·이효리·제시·화사’ 의상 바꿔 입...	스포츠경향
청양군, 고추산업 발전 위한 혁신모델 제시	충청일보
'인기가요' 블랙핑크vs박진영vs제시, 10월 셋째 주 1위 후보 '빅매치'	OSEN
세계은행 개발위 참석한 홍남기, ‘한국판 그린뉴딜’ 제시	뉴스토마토
미니음반·예능·환불원정대 다 대박…제시의 ‘전성시대’	스포츠동아
건설업계, 유보소득세 개선안 제시했다	팍스넷뉴스
춘천영화제 폐막, SF장르 새로운 가능성 제시	강원도민일보
청양군, 고추산업 발전 위한 혁신모델 제시	동양일보
청양군, 고추산업 발전 위한 혁신모델 제시	프레시안
제시, 싸이가 입지 말라는 옷 입었다.."만질 수 없어"[종합]	OSEN
제시 "유재석, 한국에서 나를 조용히 시키는 유일한 사람"	YTN
【시사】충남도의회, 축산악취 확 줄일 '묘안' 찾는다...11월 연구결과 제시	sbn뉴스
'환불원정대' 음원 1위...엄정화, "효리·제시·화사 멋져"	뉴시스
[화천]최문순 화천군수 ASF 비접촉 방역 방안 제시	강원도민일보
민주당 강원도당 성명 “대안 제시 정책국감 기대”	강원일보
제시앤코, 온라인 공략 스타트	어패럴뉴스
던, '던디리던' 인터뷰 영상 공개 "싸이·제시·크러쉬 등에게 역대급으로 도...	헤럴드POP
제시, 니트 원피스에도 감출 수 없는 글래머스 몸매 [M+★SNS]	MBN
‘놀면 뭐하니’ 유재석, 제시 ‘눈누난나’ 의상 강제 착용 “돈벌레 같아”	뉴스엔
김소니아·박지수, 제시부터 BTS까지 반전 댄스 실력 공개	데일리시큐
엄정화X이효리X제시X화사 환불원정대, '돈 터치 미' 차트 점령	텐아시아
펠로시, 부양책 대선 전 합의 데드라인 20일로 제시	연합인포맥스
인천시, GTX-D 영종행·김포행 노선 동시 추진…최적방안 제시	KBS
신한은행, 자영업자 포스트코로나 대응 전략 제시	매일일보
MIT 대학원생, AI통한 新 신약 연구법 제시	IT조선
인천시, 해양친수도시 조성 비전 제시	인천뉴스
원희룡, 대선 준비 중…이르면 이달 내 '대권 도전' 플랜 제시	더팩트언론사 선정
'대한외국인' 채리나, "제시 만나보고 싶어" ...'눈누난나' 댄스 완벽 재현	한국경제
<2020 대한민국 도시재생 산업박람회>“폐공장이 실리콘밸리로”…丁총리 ‘팩...	문화일보
맨유, 발베르데 영입 위해 FA 앞둔 포그바 제시	스포탈코리아
홈즈컴퍼니, 지역 불균형 문제 해법 제시…'스마트 코빌리지' 지자체와 맞손	매일일보
[글로벌포스트] G7 "2022년 디지털화폐 표준 제시할 것"	파이낸셜뉴스언론사 선정
제시, MBC '쇼! 음악중심' 녹화길	서울경제
김봉현, 이번엔 검찰-야당 겨눈 폭로전… 구체적 근거는 제시안해	동아일보언론사 선정
엄정화, 환불원정대 음원 1위에 "효리·제시·화사 멋져...무대 기다려져"	YTN
'제시의 쇼터뷰' 임창정 "제시 할리우드 가자, 연기는 나와 함께"	스포츠조선
[TV 엿보기] '놀면 뭐하니' 엄정화·이효리·제시·화사…의상 바꿔 입기 도전	데일리안
미래 혁신비전 제시 사업 성공 추진	경상일보
[국감] 법사위 국감에서 옵티머스 사건 관련 자료 제시하는 유상범 의원	뉴스1
[좋은정보의 '황맥기'] 9/28 제시 '금호석유' 재공략 가능! 오늘의 '황맥기' ...	MTN
임창정, '제시의 쇼터뷰' 출연…대체불가 매력부자 변신	텐아시아
김진일 의원, 기후.코로나19 위기 대응하는 경기도형 그린뉴딜 추진방안 제시	경인매일
'미래 전기차 제시' 르노, '메간 e비전' 컨셉트 공개. 2021년 출시	오토데일리
탑에듀, 2021 사회복지사1급 시험일정 대비 과목별 합격전략 제시	공감신문
정부, 'AI 반도체 산업 발전전략' 제시…인재 3천명 양성한다	뉴시스
순천교육발전을 위한 미래 통합학교 모델 제시 !	전남일보
순천교육발전을 위한 미래 통합학교 모델 제시 !	전남일보
[국감] 법사위 국감에서 옵티머스 사건 관련 자료 제시하는 유상범 의원	뉴스1
이효리-제시-엄정화-화사-유재석-정재형 ‘쇼! 음악중심’ 출격	서울경제
'아는 형님' 제시 "날 조용히시키는 사람, 유재석 뿐"	텐아시아
김봉현 전 회장 관련 자료 제시하는 장제원 의원	뉴스핌
10년 전 ‘직각 테두리’ 레트로 감성에 5G 혁신 제시한 아이폰12	민중의소리
"제시(은비)가 허심퇑하게 쏩니다" 엄정화, 환불원정대 의리 자랑 '훈훈'	스포츠조선
"韓, 강제징용 해결책 제시하지 않으면 日스가 한·중·일 정상회의 불참"(종...	뉴시스
펠로시, 대선 전 부양책 통과 위해 ‘48시간 내 합의’ 제시	스카이데일리
靑 "문제있으면 먼저 만나야"…日스가 조건 제시에 반박	노컷뉴스
펠로시, 대선 전 부양책 통과 위해 ‘48시간 내 합의’ 제시	스카이데일리
靑 "문제있으면 먼저 만나야"…日스가 조건 제시에 반박	노컷뉴스
제시, 파격 의상 입고 찰칵 "볼 수는 있지만 만질 수는 없어" [TD#]	티브이데일리
폐플라스틱으로 환경오염 해결책 제시 ... SK이노 ESG경영 일환	IT조선
옵티머스 사건 관련 자료 제시하는 유상범 의원	뉴스핌
새만금 행정구역 해법찾기 골몰… 개발 단계별 차등 추진 제시	전북일보
던, 새 앨범 ‘던디리던’ 인터뷰 공개.."싸이·제시·크러쉬 등 역대급 도움...	OSEN
'놀면 뭐하니?' 엄정화-이효리-제시-화사, 의상 바꿔 입기 현장	스타데일리뉴스
제시, 숨이 턱 압도적 섹시美..반박불가 글래머 몸매	헤럴드POP
[인터뷰] 송규만 서울건축문화제 총감독 “틈새건축으로 주거양식에 새로운 해...	서울경제언론사 선정
'놀면 뭐하니' 제시, 라도 프로듀서와 의견 충돌 "가사가 그냥 나와?"	텐아시아
IT전문기업 케어라풋, 몸캠피싱 피해자에 보안 솔루션 제시	잡포스트
정의선 현대차그룹 회장 취임…“고객·인류·미래·나눔” 지향점 제시	디지털타임스
이재명 경기지사, 문 대통령 전략회의서 '지자체 주도형 사업' 제시	경인일보
'아는 형님' 제시 "유재석, 대한민국서 날 처음으로 조용히 시킨 사람"	스포츠조선
박영선 “스마트슈퍼로 소상공인 디지털화 모델 제시”	중기이코노미
대전 중구, 내년 구정 방향 청사진 제시	중도일보
이영주 세종대 교수, 생활화학제품 '화학물질 노출' 현황 제시	뉴스1
주파수·활주로이용…무형 공공재 최적가격 이론 제시	매일경제언론사 선정
SK이노, ‘넥스트 배터리’ 방향 제시… “안전·속도·거리 핵심기술 주도”	머니S
제시, 가슴 수술 고백? "보형물 엄청 세게 쳐도 안 터져"	뉴스컬처
국감인물> 서삼석 의원...위기의 식량자급 대책 제시	전남일보
이효리-제시-엄정화-화사-유재석-정재형, 신박기획 '환불원정대' 파이팅	서울경제
“안일한 김포교육청 중학교배정 행정… 중장기 근본대책 제시해달라”	서울신문
비대면·위생 강화… '인천관광 발전' 전략 제시	경인일보
[포토]제시, 환불원정대의 은비	헤럴드POP
'식스센스' 정용화, 유재석 카리스마 일화 공개..제시 보고있나?	OSEN
'아는 형님' 제시 "유재석, 대한민국서 나를 조용히 시키는 유일한 사람"	뉴스1
'없는 살림에도' 뉴캐슬, 생막시맹에게 '6년 재계약' 제시한다	스포츠조선
"이 볼륨감, 실화?"…제시, 감탄 나오는 레깅스 자태	마이데일리
[포토]제시, 음악중심에서 만나요~	헤럴드POP
'놀면 뭐하니?' 환불원정대, 의상 바꿔 입기→걸크러시 안무 완성 (ft. 제시 ...	스포츠조선
[JB포토] 삼성 제시 고반 '원핸드 슬램덩크'	점프볼
文 대통령 "K-뉴딜에 '지역균형' 추가"...'한국판 뉴딜' 3축 제시	BBS NEWS
[회장 정의선] 정의선, 회장 취임…'고객·인류·미래·나눔' 지향점 제시	뉴스핌
OTT 시장 섭렵한 최진혁…脫지상파 시대 청사진 제시한 ‘좀비탐정’	문화일보
편입수학에 강한 편입학원 'HY이공계편입학원', 이공계 편입 입시전략 제시	데일리시큐
[TV북마크] ‘서울집’ 성시경→이수근·박하선, 집에 대한 새로운 가치관 제...	스포츠동아
SKT, 언택트 누구 컨퍼런스 2020서 AI 미래상 제시	아시아투데이
'제시의 속터뷰' 임창정, 대체 불가 매력 부자 변신	한국일보
'제시의 속터뷰' 임창정, 대체 불가 매력 부자 변신	한국일보
인천시, GTX-D 영종행·김포행 노선 동시 추진···최적방안 제시	서울경제
던, 던디리던 (Feat. 제시)’ 음원 일부 공개...9일 컴백	MK스포츠
제시, 볼륨 끝판왕..믿기 힘든 레깅스 핏	스타뉴스
[포토]제시, 음중에서 은비로 만나요~	헤럴드POP
[사진]제시 고반,'막을테면 막아봐'	OSEN
제20회 금산인삼세계화심포지엄 개최…포스트 코로나 대응 전략 제시	중도일보
'아는 형님' 제시 "유재석, 나를 조용히 시키는 단 한 사람"	헤럴드POP
네이버 카페 공인모, 2021년 9급공무원 무료인강 통해 합격 전략 제시	컨슈머타임스
제시, 가슴 깊게 파인 파격 패션 ‘명품 몸매 인증’[SNS★컷]	뉴스엔
제시, 가슴 깊게 파인 파격 패션 ‘명품 몸매 인증’[SNS★컷]	뉴스엔
[RE:TV] "컴온 제시~" '아는 형님' 제시가 밝힌 유재석 마법의 주문	뉴스1
현대제철, 수소 산업 발전 위한 '비전' 제시	프라임경제
제시, '아는 형님' 출격…"나를 조용히시키는 사람은 유재석 뿐"	스포츠서울
청양군, 고추산업 발전 위한 혁신모델 제시	대전일보
던, '던디리던' 샘플러 공개…싸이·제시 지원사격	MBC연예
엄정화 "환불원정대 1위 기뻐, 역시 이효리·제시·화사 멋져" [전문]	엑스포츠뉴스
'서울집' 성시경→박하선, 집에 대한 새 가치관 제시...'이사 뽐뿌' 부르는 신...	스포츠조선
차고지증명제로 서민 부담 가중…"개선 방안 제시하겠다"	뉴제주일보
채리나 “이효리, 핑클 때부터 눈에 띄어...제시도 만나고파”(`대한외국인`)	매일경제
2020 오대산 문화포럼, 지구적 위기의 해법과 새로운 방향 제시	BBS NEWS
獨법원, 일방적 코로나 영업제한 제동…"감염 유발 증거 제시해야"	매일경제
경기도의회 양철민 의원, 생활쓰레기 감축과 재활용률을 높이기 위한 방안 제...	위클리오늘
'아는형님' 임창정X제시X신봉선, 이유 있는 캐릭터 부자들(종합)	뉴스1
48시간 제시한 펠로시 "대선 전 경기부양안 입법 추진 낙관적"	뉴스핌
김봉현 전 스타모빌리티 회장 사건 관련 자료 제시한 장제원 의원	뉴스핌
손경식 "기업규제 손익 따져봐야"…민주당 "합리적 대안 제시해야"	노컷뉴스
김정은, 함남 검덕지구 현지시찰…"1·2단계 피해복구 제시"	뉴스1
[ST포토] 제시 고반 '슛'	스포츠투데이
인천시, GTX-D 영종행·김포행 노선 동시 추진…최적방안 제시	파이낸스투데이
인천시, GTX-D 영종행·김포행 노선 동시 추진…최적방안 제시	파이낸스투데이
손경식·박용만, '공정경제 3법'에 쓴소리…민주당 "대안 제시하라"	머니투데이
이재명 경기도지사, '공공배달앱 청사진' 제시	중도일보
KF80, KF90 등급 마스크가 필수일까? 서울시, 마스크 종류와 상황 기준 제시	문화뉴스
[정선]정선 정암사 수마노탑 보존사업 '비대면 관광' 가능성 제시	강원도민일보
제시 "EXID '위아래' 원래 내 노래였다"	텐아시아
[아이포럼 2020] 코로나19로 앞당겨진 '디지털 생활혁명'…미래 변화상 제시	아이뉴스24언론사 선정
던, 미니 1집 타이틀곡 '던디리던 (Feat. 제시)' MV 티저 공개	한국경제
제시 "유재석, 韓서 날 유일하게 닥치게 만드는 사람"(아는 형님)	스포츠조선
‘식스센스’ 장동윤, 오나라·전소민·제시·미주 화법에 “이게 매력”	MK스포츠
문화재청, 백제금동관음보살입상 환수 금액 42억 제시했지만...	뉴시스
'아는 형님' 제시 "나를 조용히시키는 사람은 유재석 뿐"	한국일보
중고차 진출 선언한 현대차‥`인증 중고차·오픈 플랫폼` 상생안 제시	이데일리
[관심 종목]빅히트, 보수적 접근해야...대부분 증권사 목표가 제시 안해	글로벌경제
"지속가능한 집단에너지사업 청사진 제시한다"	에너지데일리
양철민 경기도의원, 생활쓰레기 감축과 재활용률 높이기 위한 방안 제시	서울신문
던(DAWN), 틱톡서 타이틀곡 ‘던디리던 (Ft. 제시)’ 음원 일부 단독 선공개	스포츠동아
"한국형 뉴딜, 경기도에서 디지털 뉴딜로 구현"… 이재명, 공공배달앱 청사진...	중소기업뉴스
'놀면뭐하니' 유재석, 환불원정대 제시 의상 착용 "돈 벌레 같아"	스타뉴스
대구경북TBC)대구 경북 뉴딜 추진방향 제시	TBC대구방송
SBS '제시의 쇼!터뷰'도 이근 대위 지웠다 "에피소드 비공개 처리"[공식]	스포츠서울
[단독] 장예원, 엠넷 新오디션 ‘캡틴’ 단독 MC…이승철·제시 등과 호흡	부산일보언론사 선정
벨롱벨롱나우 페스티벌, 코로나 시대 ‘문화예술섬 제주’ 플랫폼 방향 제시	NSP통신
충남도의회, 보건지소 중심 통합돌봄 방안 제시	브레이크뉴스
국고채 2년물 발행물량 등 구체적 내용은 추후 제시 - 국고국장	한국금융신문
[투데이TV]'대한외국인' 채리나 "이효리, 핑클 때부터 눈에 띄었다..제시 만나...	헤럴드POP
`아는 형님` 제시 “대한민국에서 나를 조용히시키는 사람? 유재석 뿐"	매일경제
일산가구단지 '에르노소파', 프리미엄 측-후면 통가죽쇼파 합리적인 가격 제시	한국목재신문
UN보고관 "北 피격은 국제법 위반···韓도 월북 증거 제시하라"	중앙일보언론사 선정
던, ‘던디리던’으로 자유롭게 날다(feat. 파워풀한 제시) [M+가요진단]	MBN
던, ‘던디리던’으로 자유롭게 날다(feat. 파워풀한 제시) [M+가요진단]	MBN
"2030년까지 美·中·유럽에 6.4만대"…현대차, 수소트럭 수출 로드맵 제시	디지털타임스
조길형 충주시장, '자연과 생활이 조화로운 품격 있는 도시' 제시	뉴스타운
‘아는 형님’ 제시, 남다른 환불 스타일 설명… 캡사이신, 제시 에너지에 감...	MBC연예
임창정, '제시의 쇼터뷰' 출연..역시 만능 엔터테이너	OSEN
엄정화 “제시 효리 화사 1위 멋져, 무대 설 생각에 긴장”	뉴스엔
'놀면 뭐하니?' 제시 "환불원정대 녹음 끝까지 지켜본 유재석, 말라 비틀어져...	뉴스1
천안시의회 김각현‧박남주‧이교희 의원, 5분 발언 통해 시정방향 제시	시사뉴스24
엄정화, 제시가 선물한 커피차 인증..."은비가 허심퇑하게 쏩니다"	매일경제
사이버공격 증가…'위기의 개인정보' 대응책으로 KDFT 정보보호 포렌식 솔루션...	마이데일리
[인터뷰①]'삼진그룹' 이솜 "할 말은 하는 편…유나役에 적극적으로 의견 제시...	스포츠조선
엄태준 이천시장, 지역경제 활성화 방안 제시	경기일보
KT의 존 디펜스를 무력화시켰던 제시 고반, 출전시간이 19분 15초인 이유	점프볼
[단독] '도굴' 이제훈·조우진, '쇼터뷰' 출연…제시 만난다	엑스포츠뉴스
던, 9일 1st 미니앨범 ‘던디리던’ 발매…싸이·제시·크러쉬 피네이션 사단...	한국경제TV
'제시의 쇼터뷰' 임창정, 연기 수업→먹방-히트곡 메들리까지 '팔색조 매력'	헤럴드POP
'아는 형님' 제시 출격! "날 조용히시키는 사람은 유재석 뿐"	JTBC
[사진]제시 고반,'파워 넘치는 투핸드 덩크슛'	OSEN
단대·서울의대, 코폴립 발병 원인-치료법 제시	의학신문
[N컷] '옥문아' 제시 "EXID '위아래' 원래 내 노래였다"	뉴스1
[N컷] '옥문아' 제시 "EXID '위아래' 원래 내 노래였다"	뉴스1
신촌토익학원 파고다 실전반 전문 종결토익, 비대면 수업 통한 고득점 전략 제...	공무원수험신문
[김진홍의 아침묵상] 창의력을 어떻게 기를 것인가?(9) 모세가 제시한 제3의 ...	크리스천투데이
엄태준 이천시장, 지역경제 활성화 방안 제시	인천일보
플래티어, '코로나 이후 AI 개인화 마케팅 수요 급증' 그루비 분석 통계 제시	전자신문
현대차그룹 혁신 짊어진 정의선 회장, ‘인류’·‘미래’·‘나눔’ 지향점 ...	아주경제
'대한외국인' 채리나, "제시와 만나보고 싶어"	스타데일리뉴스
[ST포토] 제시 고반, 막을 수 없어	스포츠투데이
제시 '던 지원사격'[★포토]	스타뉴스
충남도의회, 청년농업인·보건지소 중심 통합돌봄 방안 제시	신아일보
충남도의회, 청년농업인·보건지소 중심 통합돌봄 방안 제시	신아일보
제시, 니트 원피스로 드러낸 완벽 S라인..'환불원정대' 은비의 일상	뉴스인사이드
한국지엠 부평2공장 생산 일정 연장 제시	매일노동뉴스
‘대한외국인’ 채리나 “이효리 핑클 때부터 눈에 띄어..제시 만나고파”	뉴스엔
WHO, ‘코로나 재유행’ 서방세계에 한국 등 방역 본보기로 제시	이투데이
'옥문아' 제시 "EXID '위아래' 원래 내 곡이었다" 충격 고백	스포츠조선
[팝's신곡]"난 던이라고 해"‥던이 말하는 DAWN '던디리던'(ft.제시)	헤럴드POP
콧속 물혹의 발병 원인 밝히고 새로운 치료법 제시	메디컬투데이
[SC현장] "♥현아→제시·싸이 응원"…던, 자유분방 '던디리던' 컴백(종합)	스포츠조선
‘라임·옵티머스’ 여권 연루설 차단한 김태년 “권력형 게이트? 근거 제시하...	민중의소리
‘라임·옵티머스’ 여권 연루설 차단한 김태년 “권력형 게이트? 근거 제시하...	민중의소리
"난 던이라고 해" 던, 미니 1집 타이틀곡 '던디리던 (Feat. 제시)' MV 티저 공...	일간스포츠
[사진]던X제시, '잘 어울리는 조합'	OSEN
‘아형’ 제시 “대한민국서 날 조용히시키는 사람은 유재석 뿐”	뉴스엔
고객·인류 ·미래 ·나눔…정의선 회장, 경영비전 제시[취임사 전문]	아시아타임즈
충남도의회, 청년농업인·보건지소 중심 통합돌봄 방안 제시	위클리오늘
LG헬로비전, 코로나19 속 지역채널로 여행 답 제시	한국금융신문
간삼건축, 2020도시재생박람회에서 지방소멸 해법 제시	이데일리
경기도의회 김진일 의원, 기후·코로나19 위기에 대응하는 경기도형 그린뉴딜...	위클리오늘
'아는형님' 임창정X제시X신봉선, 실력만큼 뛰어난 입담 (종합)	헤럴드POP
'아는형님' 임창정X제시X신봉선, 실력만큼 뛰어난 입담 (종합)	헤럴드POP
제시-던 '돋보이는 케미'[★포토]	스타뉴스
[단독] 제시·던 잇는 피네이션 컴백 주자는 크러쉬…초호화 피처링 예고	뉴스1
염태영 시장, 이클레이에 기후위기 대응 청사진 제시	환경일보
양철민 의원, 생활쓰레기 감축과 재활용률 높이기 위한 방안 제시	경인매일
'제시의 쇼!터뷰', 이근 대위 출연 회차 비공개 전환 '방송가 손절ing'	마이데일리
엄태준 이천시장, 지역경제 활성화 방안 제시	브릿지경제
수원가구단지 리퍼브가구 전문매장 '세계로가구', 최대 할인 도매가격 제시해...	뉴스렙
제시 “유재석, 날 조용히 시키는 유일한 사람”	이데일리
제시, 파격적 의상도 완벽 소화…"You can look and stare but don't touch m...	뉴스인사이드
제시 “유재석, 날 조용히 시키는 유일한 사람”	이데일리
제시, 파격적 의상도 완벽 소화…"You can look and stare but don't touch m...	뉴스인사이드
이연희 서산시의회 의장 "뉴노멀 시대 지방의회 방향" 제시	디트뉴스24
트럼프 "부양책 1조8000억달러 이상 제시"…펠로시 압박	이데일리
"병든 닭 잡으려다 다른 닭도 위험" vs "안 된다고만 말고 합리적 대안 제시"	한국일보
무협 '2020 신남방 비즈니스 위크'…상생번영 위한 미래비전 제시	아시아경제
김진일 경기도의원, 기후.코로나19 위기 대응하는 경기도형 그린뉴딜 추진방안...	서울신문
미래기술교육硏, '그린뉴딜' 앞장… 수소전기차 미래전략방안 제시한다	국토일보
'0개의 사무실에 팀원은 68개국·1300명'…깃랩, 원격근무 노하우 제시	아이티비즈
교황, 故로베르토 말제시니 신부 유가족과 따뜻한 만남	가톨릭평화방송·평화신문
LG화학, 배터리 분할 배경 설명과 비전 제시로 주주 설득 나서	테크월드
`옥문아들` 제시 "EXID `위아래` 원래 내 곡이었다"	매일경제
수협중앙회, 기장수협에 지속성장 위한 전략 제시	농수축산신문
'아형' 제시 "유재석, 똑똑해…'컴온 제시' 들으면 말문 막혀"	엑스포츠뉴스
던 “제시 목소리 들으면 힘 나…든든한 지원군”	스포츠월드
국내연구팀, '콧속 물혹' 발병 원인 밝히고 새 치료법 제시	뉴시스
[단독]유엔특별보고관 “北, 피격 공무원 사살 이유 밝혀야… 한국도 월북 증...	동아일보언론사 선정
“남자한테 '성추행' 당했다...” 제시가 한 말에 '이근'이 보인 반응 (사진)	위키트리
[MJ포토] 제시(Jessi)-던(DAWN), '환상의 케미'	문화저널21
제시 “대한민국에서 나를 처음으로 조용히 시킨 사람은…”	위키트리
제시 “대한민국에서 나를 처음으로 조용히 시킨 사람은…”	위키트리
[포토] 이효리-제시, ‘돈독한 케미’	파이낸셜뉴스
이재명, 경기도 뉴딜사업 '공공배달앱' 청사진 제시	위클리오늘
[ST포토] 제시 고반 '빈틈이 보이면 바로 슛'	스포츠투데이
'대한외국인' 채리나 "이효리가 내 팬? 영광이다…제시 만나보고파"	TV리포트
용인시, 벤처창업 펀드 조성…내년도 추진 과제·전략 제시	뉴스1
충남도의회, 청년농업인·보건지소 중심 통합돌봄 방안 제시	충청일보
[포토] 제시, ‘꿀떨어지는 눈빛’	파이낸셜뉴스
‘9일 컴백’ 던, 미니 1집 타이틀곡 ‘던디리던’ MV 티저 공개(Feat. 제시)	MK스포츠
[포토] 제시, ‘속삭이듯 손인사’	파이낸셜뉴스
[포토] 제시, ‘속삭이듯 손인사’	파이낸셜뉴스
[염홍철 아침단상 1000회] "다양한 이슈, 균형감있는 시각 제시"	중도일보
프런트·현장 갈등의 시대, KT가 제시한 신뢰와 역할분담의 힘	스포츠동아
‘제시의 쇼!터뷰’ 측 “이제훈·조우진 출연 확정”(공식)	뉴스엔
[글로벌-이슈 24] 펠로시. 부양안 협상 마감시한 48시간 제시	글로벌이코노믹
콧속 물혹 발병 원인 규명···新치료법 가능성 제시	데일리메디
[MJ포토] 던(DAWN)-제시(Jessi), '찰떡궁합 콜라보'	문화저널21
'9일 컴백' 던, 제시 피처링+MV 출연 '던디리던' 티저 공개	엑스포츠뉴스
[사진]던과 협업한 제시, '어디서나 카리스마'	OSEN
코로나19 과학적 극복방안 제시…IBS ‘코로나 사이언스’ 발간	헤럴드경제
대경병무청, 현역 입영의 길 제시	경상매일신문
박진영 vs 제시 vs 블랙핑크, '인기가요'서 2주 연속 격돌	티브이데일리
"코로나 시대, 새로운 이정표 제시한 탐라문화제"	제주의소리
'옥탑방 문제아들' 제시 "EXID '위 아래' 원래 내 노래였다"	스포츠서울
`오락가락` 트럼프, 이번엔 경기부양책 확대 제시…"통 크게"	디지털타임스언론사 선정
김태년 "野, 라임·옵티머스 '카더라 통신' 말고 '근거 제시'해야"	시사포커스
레페리 ‘레페리 마케팅 컴퍼니’ 사이트 오픈···신개념 인플루언서 마케팅...	서울경제
김승연 회장, 한화그룹 미래 화두 제시...포스트 코로나·디지털·지속가능	소비자가 만드는 신문
제시, 던 지원사격도 성격만큼 '화끈하게~'	enews24
IBS, 새로운 화학반응 실험법 제시	대전일보
대구시, 지역균형뉴딜 포럼서 대구형 뉴딜 추진방향 제시	뉴데일리
한국, 주변국과 협업으로 선도… 이제 뉴노멀 제시할 때	서울신문
매력적인 해양친수도시 인천'조성을 위한 비전 제시	위클리오늘
제시, 블랙핑크 지수X리사와 한 손 번쩍...미녀들의 `눈누난나`	매일경제
'고영' 사라던 신한금투, 연일 매도中...유진투자는 '중립', NH는 '매도' 제시	더밸류뉴스
제시 돌발 고백 "내 가슴 옛날 실리콘…팍! 세게 쳐도 안 터진다"	뉴스1
장동윤, 제시 한 번 만나보고 싶다? 이유 알고보니…	뉴스컬처
군산시의회, 지역 현안 다양한 의견 제시	전북도민일보
제시, 블랙핑크 지수X리사와 찰칵..8등신 모델 포스(ft.눈누난나)	스타뉴스
'인기가요' 블랙핑크, 제시·박진영 꺾고 1위 "팬들에 감사"	티브이데일리
일산가구단지 '에르노소파', 현대인의 입맛맞춘 프리미엄 통가죽쇼파 입주특가...	경기도민일보
'옥탑방의 문제아들' 제시, 가장 센 언니 묻는 질문에 "이효리 아냐"	한국경제
제시, 가슴 수술 고백 "누가 엄청 세게 쳐도 안 터진다고"	SBS funE
‘컴백’ 던, 제시 참여 ‘던디리던’ 음원 일부 선공개 ‘분위기 ↑’	뉴스엔
서울시, 코로나 고용위기 1만 개 일자리 정책 제시	파이낸셜뉴스언론사 선정
"한국판 뉴딜, 세계 경제 전환 구심점" 제안...홍남기, 3대 과제 제시	청년일보
제시 '은비 왔어요'[★포토]	스타뉴스
고점례 북구의원, 안전행정·현안사업 방향 제시	남도일보
[포토] 환불원정대 제시, ‘작은얼굴~비율갑’	파이낸셜뉴스
'놀면뭐하니?' 은비 제시, '툭지훈' 라도와 티격태격…오늘(10일) 음원 발매	스포츠조선
'놀면뭐하니?' 은비 제시, '툭지훈' 라도와 티격태격…오늘(10일) 음원 발매	스포츠조선
'컴백 D-1' 던(DAWN), 틱톡에서 타이틀곡 '던디리던 (Feat. 제시)' 음원 일부...	헤럴드POP
던 "'던디리던', 크러쉬·제시·싸이 선배님 참여로 완성"	뉴시스
[2020 정보과학 인재양성 우수학교·교사 공모전]부산연포초 등 교육부 장관상...	전자신문언론사 선정
'아는형님' 제시 "소속사 대표 싸이, '야하게 입지 말라'고 한다"	뉴스1
던(DAWN), ‘던디리던 (Feat. 제시)’ 안무 연습 영상 공개 “발재간 춤 외 재...	한국경제TV
하이디자인, '패키지 브랜딩 연구소' 설립…패키지 환경문제 해결 대안 제시	글로벌경제
원 지사 대권출마 공식화 “다음 달 비전 제시”	KBS
던, 오늘(9일) 첫 미니앨범 ‘던디리던’ 발매…싸이·제시·크러쉬 지원사격	뉴스엔
여주 이포초, 시골학교 장점 극대화해 미래학교 모델 제시	국민일보
제시, 볼륨감 폭발 레깅스 자태...`이 몸매 실화?`	매일경제
제시, 환불원정대 엄정화에 커피차 선물 “허심�B하게 쏩니다”[SNS★컷]	뉴스엔
천안시의회, 5분발언 통해 시정방향 제시	대전투데이
정책기획위, 방역·경제 선순환 패러다임 전환 제시	시사위크
'환불원정대' 리더 천옥의 스타일 PICK! '엄정화-이효리-제시-화사' 의상 바꿔...	엔터미디어
정의선 현대차그룹 회장 취임…혁신 지향점 '인류' '미래' '나눔' 제시	인사이트코리아
‘컴백 D-1’ 던(DAWN), 틱톡에 타이틀곡 ‘던디리던 (Feat. 제시)’ 음원 일...	스포츠경향
실패한 실험 월북 증거로 제시한 해경…"전형적인 짜맞추기 수사"	한국경제
현대차그룹, 싱가포르 글로벌 혁신센터서 미래 모빌리티 패러다임 제시	아주경제
'식스센스' 유재석→제시, 현재 육감 왕과 6위는 누구?	한국일보
‘놀면 뭐하니?’ 제시, 라도와 의견 충돌! 카리스마+엉뚱美 시선강탈	MBC연예
'성추행 벌금형' 이근 대위, 제시에겐 치한 퇴치 호신술 교육…"모순"	머니투데이
단국대의대, 콧속 물혹 새로운 치료법 제시	디트뉴스24
제시 “한국에서 처음으로 날 조용히 시킨 유재석, 정말 똑똑해”(아형)[어제...	뉴스엔
제시, 블랙핑크 지수·리사와 카리스마 발산…'대세들의 만남' [데일리SHOT]	마이데일리
인천시, '매력적인 해양친수도시 인천' 조성을 위한 비전 제시	이뉴스투데이
[MJ포토] 제시(Jessi), '소울 가득 담은 무대'	문화저널21
제시 "'소속사 대표' 싸이, 옷 좀 야하게 입지 말라고…" ('아는형님')	마이데일리
엄태준 이천시장, 지역경제 활성화 방안 제시	매일일보
[종합] `아는 형님` 임창정X제시X캡사이신, 산전수전 공중전 다 겪은 막강 전...	매일경제
[종합] `아는 형님` 임창정X제시X캡사이신, 산전수전 공중전 다 겪은 막강 전...	매일경제
`아는 형님` 제시, "SM·도레미 중 도레미 선택... 언프리티 랩스타로 이름 알...	매일경제
野, 해류 시뮬레이션까지 제시하며 해경 '월북 판단' 반박	연합뉴스
민주 "라임·옵티 사건은 금융사기...야당 근거 제시하라"	TBS
충남도의회 '소멸 우려지역 기본소득 지급' 정책 실험 방안 제시	충남일보
'컴백 D-1' 던 "제시 선배님, 든든한 지원군 그 자체"	엑스포츠뉴스
G20 경제 리더들, 지구적 불황 맞아 22개 개혁안 제시	파이낸셜뉴스언론사 선정
제시 '환불원정대 은비의 랩'[★포토]	스타뉴스
신한금융투자, '보이지 않는 시대' 나침반 제시	오늘경제
무협 '2020 신남방 비즈니스 위크' 개최···상생·번영 위한 미래비전 제시	아주경제
‘아형’ 제시, 험난했던 데뷔 스토리 “SM 합격→언프리티 랩스타”	뉴스엔
피카프로젝트, 8개월간 이례적인 성과…미술품 시장에 새 패러다임 제시	헤럴드경제
[포토] 던 신곡 '던디리던' 피처링 맡은 가수 제시	뉴데일리
제시가 미국서 '성추행' 당했다는 말에 호신술 알려줬던 이근 대위	인사이트
'옥문아' 제시 "EXID '위아래', 원래 내 노래였다" 비화 공개	한국일보
던(DAWN), 제시 피처링·출연 '던디리던' M/V 티저 2탄 공개 '시선강탈'	열린뉴스통신
송하진 도지사, '지역균형 뉴딜'과 '전북형 뉴딜'을 위한 정책제언 제시	위클리오늘
[포토] 환불원정대 제시-화사, ‘대비되는 계절감각’	파이낸셜뉴스
(2020 국감)국민연금 고갈 우려 '개혁' 여·야 공감, 김용진 이사장 "방향 제...	뉴스토마토
[종합] “난 던이라고해”…던, 제시와 함께 힙한 컴백	스포츠동아
[포토] 환불원정대 제시-화사, ‘대비되는 계절감각’	파이낸셜뉴스
(2020 국감)국민연금 고갈 우려 '개혁' 여·야 공감, 김용진 이사장 "방향 제...	뉴스토마토
[종합] “난 던이라고해”…던, 제시와 함께 힙한 컴백	스포츠동아
[MJ포토] 제시(Jessi), '빠져드는 강렬한 카리스마'	문화저널21
‘아는 형님’ 제시 “대한민국에서 나를 조용히시키는 사람은 유재석 뿐”	MBN
현대차, 중고차 시장 진출…중기부 "상생안 제시 해야"	이코노믹리뷰
[단독] 던, 9일 '뮤직뱅크'서 신곡 '던디리던' 최초 공개..제시 동반 출연	OSEN
김진일 의원, 경기도형 그린뉴딜 추진방안 제시	농업경제신문
엄정화, 제시 커피차 인증 "은비가 허심퇑하게 쏩니다"...환불원정대 의리 [★...	엑스포츠뉴스
해경청장, 北피살 공무원 월북 정황 제시 "2∼3시 실종 추정"	파이낸셜뉴스언론사 선정
국내 연구진, 콧속 물혹 '코폴립' 새 치료법 제시	라포르시안
환불원정대 유재석, 제시 보디슈트 입고 파격.."돈벌레 같아" 초토화 (놀면뭐...	OSEN
던, '던디리던' 샘플러 공개…싸이·제시·크러쉬 지원사격	뉴시스
던, '던디리던' 오늘 발매..싸이·제시·크러쉬 피네이션 사단 총출동	일간스포츠
日 "150억 내라"…'백제미소보살' 환수 결국 무산, 韓은 42억 제시	아시아경제언론사 선정
김태년, 야당 향해 "라임 옵티머스 사건 비리게이트라는 근거 제시하라"	민주신문
제시 `던 위해 지원사격` [MK포토]	MK스포츠
"광주광역시가 다른 지방정부에 탄소중립 이정표를 제시했습니다"	충청리뷰
“지구촌 평화·안정 구축 목표 대안 제시하겠다”	국방일보
"한국말 못하는 게 콘셉트?" 오해·편견에 대한 제시의 '답'	오마이뉴스
"한국말 못하는 게 콘셉트?" 오해·편견에 대한 제시의 '답'	오마이뉴스
[어게인TV] '대한외국인' 채리나, "이효리, 처음 보고 너무 예뻐 놀라... 제시...	헤럴드POP
[피플&데이터] 주파수 등 ‘공공재 경매’ 새틀 제시…노벨경제학상 로버트 윌...	헤럴드경제
대외관계 개선 염두 둔 “인민의 번영” 새 목표 제시	한겨레
송하진 전북도지사, '지역균형 뉴딜'과 '전북형 뉴딜'을 위한 정책제언 제시	베타뉴스
'식스센스' 유재석→제시, 매회 날카로운 추리…현재 '육감왕'은 누구	엑스포츠뉴스
엄태준 이천시장, 지역경제 활성화 방안 제시	MTN
BSG파트너스-그루매틱, 줄줄세는 클라우드 운영비용 절감 해법 제시	전자신문
"기대해도 좋다"…던, 제시·싸이·크러쉬·♥현아 응원 속 11개월만 컴백 [종...	마이데일리
'인기가요' 블랙핑크 1위, 박진영 제시와 경합 [TV캡처]	스포츠투데이
김선홍, 김월영, 허욱, 권오중 천안시의원 시정방향 제시	충청뉴스
'아는 형님' 제시, "대한민국에서 나를 조용히시키는 사람은 유재석 뿐"	스타데일리뉴스
‘9일 컴백’ 던, 미니 1집 타이틀곡 ‘던디리던(Feat. 제시)’ 감각적인 퍼포...	한국경제TV
나경원 "與 최고위원 완장 무섭다…신동근이 수사 가이드라인 제시"	더팩트
㈜엠금융서비스 MVP사업단, 불경기 속 올바른 금융상품 선택법 제시	파이낸스투데이
경찰, QR코드 제시 요구한 주점 직원 급소 가격한 여성 입건	MBC
가수 제시, 인스타그램서 화보 같은 힙한 일상 뽐내	스포츠조선
충남도의회, '농어촌 주민기본소득' 정책 실험 방안 제시	뉴스티앤티
피네이션 수장 싸이, 제시→던 이을 컴백 주자 발표 예고	일간스포츠
제시 '환불원정대 은비가 나가신다'[★포토]	스타뉴스
제시가 세상에 전하고 싶은 이야기	GQ
게리 네빌, "우드워드-레비 손에 PL 운영되는 꼴 못 본다"...새로운 대안 제시	엑스포츠뉴스
`옥문아들` 제시 "이효리는 리더 스타일, 진짜 센 언니는 박나래"	매일경제
"어디까지 봐야" 유교보이 유재석, 전소민X제시 가슴 튕기는 바디파이브에 '경...	OSEN
삼일회계법인, 코로나19 시대 감사위원회를 위한 가이드 제시	파이낸셜뉴스
던 "연인 현아부터 제시·크러쉬·싸이 전폭적 지원 받아"	일간스포츠
던-제시 `강렬한 레드 속에서` [MK포토]	MK스포츠
‘컴백’ 던 “‘던디리던’, 크러쉬·제시·싸이 참여…나도 기대 돼”[톡★...	스포츠월드
‘식스센스’ 제시, 유재석과 ‘시발 자동차’ 두고 티격태격	뉴스엔
[포토]제시, 던 신곡무대 함께	매일경제
대구경북TBC)대구경북형 뉴딜 종합계획 제시	TBC대구방송
‘식스센스’ 유재석, 전소민·제시 바디파이브에 경악 “내가 어디까지 봐야...	MK스포츠
이재명, 한국판 뉴딜 전략회의에서 공공배달앱 청사진 제시	더퍼블릭
‘놀면’ 유재석, 제시 보디슈트 입고 ‘눈누난나’ 안무 “돈벌레 같아”[결...	뉴스엔
용인시의회, ‘5분 자유발언’ 통해 용인시 발전 방향 의견 제시	경기신문
[포토]제시, 던 신곡 지원사격	매일경제
[어게인TV] '아는형님' 캡사이신 신봉선, 갑자기 제시 엉덩이 칭찬..."그림 같...	헤럴드POP
충남소방, 청렴한 조직문화 구현…비전 제시	신아일보
충남도의회 '소멸 우려지역 기본소득 지급' 정책실험 방안 제시	위클리오늘
'식스센스' 장동윤 출격, 오나라X전소민X제시X미주, 사상 최초 게스트에 초집...	스포츠조선
인천시, 친수 공간 특화방향으로 5대 추진전략 제시	브레이크뉴스
제시 “소속사 사장 싸이, 옷 야하게 입지 말라고 관리해”(아형)[결정적장면...	뉴스엔
"권력형 게이트" vs "근거 제시해라"…김영춘, 검찰 출두 조율	MBN
신한금융투자, '무형시대' ZERO 리포트 발간...'보이지 않는 시대' 나침반 제...	더퍼스트
제시, 하의실종 패션으로 뽐낸 구릿빛 각선미 '섹시+탄탄'	데일리한국
‘버릇없는 여자’서 섭외 1순위 된 제시…판단 불가한 매력	중앙일보
제시X블랙핑크 지수X리사, 누가 더 화려한가..시선 압도하는 비주얼[★SHOT!]	OSEN
이근 대위, '제시의 쇼!터뷰'서도 사라졌다	머니S
원주시, 육군사관학교 원주 이전 방안 제시	LG헬로비전
[포토] 이효리-제시-엄정화-화사, ‘독보적인 존재감’	파이낸셜뉴스
'성추문' 이근 대위, '제시의 쇼터뷰' 영상도 비공개 처리	조이뉴스24
“경제 3법·노동법 원샷 처리하자”… 국민의힘, 與에 ‘패키지 딜’ 제시	세계일보언론사 선정
'아형' 제시, '요즘 대세'라는 소개에 도망.."부끄러워"	스타뉴스
법원, ‘한글날 집회’ 모두 금지..."방역대책 제시 못해"	에너지경제
‘식스센스’ 제시, 금감 6개 보유하며 육감왕 등극‥촉 제대로 올랐다	뉴스엔
펠로시, 경기부양책 마감시한 제시...“대선 전 합의하려면 48시간 안에 끝내...	이투데이
'옥탑방의 문제아들' 제시, "EXID '위 아래' 원래 내 곡이었다"	톱데일리
환불 원정대 제시부터 블핑 지수까지! 셉럽들의 레오퍼드 패션 7	엘르
던 '던디리던', 싸이 프로듀싱·제시 피처링…이보다 좋을 순 없다	한국경제
인천시 ‘매력적인 해양친수도시’ 조성 위한 비전 제시	중앙일보
'옥문아' 제시 "가슴 수술 예전에 해…팍 쳐도 안터진다더라" 솔직	이데일리
뉴미디어 시대, 새로운 비전 제시하는 ㈜몽규	매일경제
‘식스센스’ 유재석, 전소민 제시 가슴 보디파이브에 질색[결정적장면]	뉴스엔
[포토]던, 제시와 함께 신곡무대	매일경제
'아는형님' 캡사이신 신봉선 "제시 엉덩이, 그림처럼 예뻐"	마이데일리
제시, 피처링 하러 와서 폭풍래핑[NC포토]	뉴스컬처
정부 모호한 `특례시'권한 제시해야	충청타임즈
'컴백' 던, 신곡 '던디리던' MV 티저 오픈···제시 지원사격	일간스포츠
‘놀면’ 제시, 환불원정대 녹음 중 라도와 의견 충돌[오늘TV]	뉴스엔
인천시, 국제적 해양친수거점 육성 등 '해양친수도시 인천' 위한 5대 추진전략...	경기일보
인천시, GTX-D 영종행·김포행 노선 동시 추진…최적방안 제시	연합뉴스
던, 미니 1집 '던디리던' 인터뷰…"싸이·제시·크러쉬 등 도움받아"	컨슈머타임스
'식스센스' 제시, 육감왕 등극하나 금감 개수 1위..오나라 꼴찌	OSEN
예측할 수 없는 미래, 흔들리지 않을 가이드라인을 제시하다	데일리경제
제시 “과거 가슴 수술… ‘팍’ 쳐도 안 터진다더라” 솔직 고백 ‘폭소’	스포츠조선
"콧속 물혹의 발병 원인 밝히고 새로운 치료법 제시"	메디파나뉴스
던(DAWN) 미니 1집 ‘던디리던’ 샘플러 공개…싸이·제시 지원사격	스포츠동아
던, 오늘(9일) '뮤직뱅크'서 타이틀곡 '던디리던' 최초 공개..제시 동반 출연...	OSEN
제시 "EXID의 '위아래' 원래 내 노래, 녹음까지 마쳤지만 포기" ('옥탑방의 문...	마이데일리
제시, ‘엘리트+훈남’ 친오빠들 자랑 “덕분에 성공”	국민일보
지상파-OTT-IPTV 합작 '좀비탐정', 첫 오리지널 콘텐츠의 긍정적 사례 제시	스포츠서울
'던디리던' 던, '눈누난나' 제시 이어 대박 칠까 [종합]	이데일리
“버릇없는 女”에서 섭외 1순위 된 제시…판단 불가한 매력	중앙일보
[포토]던-제시, '현아도 질투할 케미'	헤럴드POP
'정의당 신임대표’ 김종철 “대선승리·평화군축·여당과 경쟁” 3가지 목표...	헤럴드경제
던(DAWN), ‘던디리던 (Feat. 제시)’ 안무 연습 영상 공개 “발재간 춤 외 재...	스포츠경향
[포토]던-제시, '피네이션'의 남매	헤럴드POP
[200자 읽기] 생태적 복원 성공·실패 사례 제시	국민일보
'9일 컴백' 던(DAWN), 타이틀곡 '던디리던(Feat. 제시)' 감각적인 퍼포먼스 티...	헤럴드POP
충남소방, 청렴한 조직문화 비전 제시	브릿지경제
충남소방, 청렴한 조직문화 비전 제시	브릿지경제
청양군, 고추산업 발전 위한 혁신모델 제시	내외경제tv
'컴백' 던 "제시·싸이·현아, 응원하고 도움 줘…든든"	뉴스1
비대면 학습환경 제시 전남대, '가상현실' 활용한 진로교육	뉴스워커
놀면 뭐하니 제시, 화보 같은 힙한 일상 뽐내	스포츠서울
제시 “근데 재석 오빠는 시X되고, 나는 왜 안 돼요?” (영상)	위키트리
던, 오늘(9일) 컴백..신곡 ‘던디리던’ 발매 ‘싸이·제시·크러쉬 피네이션...	OSEN
[e이천소식] "소상공인 매출증대 도모"…엄태준 이천시장, 언론 브리핑서 지역...	중부일보
정병선 차관 "미래변화 예측해 과학기술 정책 방향 제시해야"	뉴시스
'놀면 뭐하니?' 제시, 라도와 의견 충돌..카리스마 폭발 '당황'	enews24
서욱 "北 선박에 처음 월북 표명"…'감청 내용'은 제시 안해 논란	TV조선
‘식스센스’ 장동윤 “원픽 멤버 제시, 한 번 만나보고 싶어”	뉴스엔
제시, 가슴 수술 고백 "보형물 엄청 세게 쳐도 안 터져"[스타이슈]	스타뉴스
‘뉴딜펀드’ 가이드라인 나왔다…“40분야 197사례 제시”	SBS CNBC언론사 선정
던, 미니 1집 ‘던디리던’ 샘플러 영상 공개…싸이-제시-크러쉬 지원사격	한국경제
[포토] 제시 '강렬한 무대'	세계일보
"권력형 게이트" vs "근거 제시해라"…김영춘, 검찰 출두 조율	MBN
LG화학, 배터리 분할 ‘청신호’ …양대 의결권 자문기관 찬성 의견 제시	더퍼블릭
'아는 형님' 유재석이 제시를 조용히 시키는 방법은?...임창정의 음향 사고 대...	문화뉴스
제시, 최대 관심사가 임신? 이유 알고보니…	뉴스컬처
'2020 의정부포럼' 포스트 코로나 시대 지방정부 혁신 방향 제시	기호일보
던(DAWN), 미니 1집 타이틀곡 ‘던디리던 (Feat. 제시)’ M/V 티저 공개	스포츠동아
'놀면 뭐하니' 엄정화X이효리X제시X화사, 언니들의 '찐' 우정 [전일야화]	엑스포츠뉴스
[단독]이근 대위, '제시의 쇼!터뷰' 영상서 사라져.."비공개 결정"	스타뉴스
워크데이, 21일 조직 리더 위한 난국 타개 비법 제시한다	ZDNet Korea
충남소방, 청렴한 조직문화 구현…비전 제시	충청일보
'아형' 제시 "유재석 유일하게 날 컨트롤"..신봉선=캡사이신[★밤TView]	스타뉴스
[정의선 회장 취임사 전문] "고객·인류·미래·나눔" 지향점 제시	뉴스웍스
제시, 레깅스로 뽐낸 군살제로 글래머 몸매..치명 눈빛	헤럴드POP
㈜몽규, 4차 산업혁명 기술 영상 콘텐츠 제시..새로운 홍보콘텐츠 선봬	비지니스코리아
㈜몽규, 4차 산업혁명 기술 영상 콘텐츠 제시..새로운 홍보콘텐츠 선봬	비지니스코리아
'놀면 뭐하니?' 환불원정대 제시, 명불허전 랩실력에 '기립박수'…'돈터치미'...	스포츠서울
이재명, 공공배달앱 청사진 제시…한국형 뉴딜이 경기도 디지털 뉴딜로	쿠키뉴스
'식스센스' 장동윤, 가짜 식당 찾아냈다…제시 '4연승'	텐아시아
'옥문아' 제시 "이효리 리더십→나랑 잘맞아…유재석은 배우고 싶은 사람"	스포츠조선
전참시' 오마이걸·제시, 웃음·감동 '반전 일상' 대공개	한국경제
인천경제청, 투자유치 비전 '세계적 수준 바이오도시' 제시	이데일리
던, 오늘(9일) ‘뮤직뱅크’서 ‘던디리던’ 무대 최초 공개…제시 동반 출연	MBN
'옥탑방의 문제아들' 제시 "EXID '위아래', 녹음까지 하고 포기해"	한국경제
'던 지원사격' 제시, 레깅스+가죽 코트…카리스마 '폭발'	머니투데이
요빗이 제시하는 암호화폐로 돈버는 방법, '가상채굴'	코인리더스
제시, 여전사 포스[포토엔HD]	뉴스엔
소속사 사장 싸이가 "옷 좀 야하게 입지 말라"고 말하자 제시가 보인 반응	위키트리
'옥문아' 제시 "이효리, 리더십 뛰어나…박나래는 멋진 언니"	한국일보
[포토] 던-제시 '완벽한 호흡'	세계일보
'코로나19로 증가한 배달·과대 포장'…하이디자인, 환경문제 해결 위한 대안...	매일경제TV
'식스센스' 장동윤, 게스트 출격…오나라·전소민·제시·미주 초집중	엑스포츠뉴스
통신 장애 예측하고 해결책 제시까지…KT 네트워크 AI 들여다보니	브릿지경제
[속보]정의선 현대차그룹 회장 취임.."고객·인류·미래·나눔" 혁신지향점 제...	머니투데이언론사 선정
소자본창업 전문 '두찜(두마리찜닭)', 남다른 배달 노하우 앞세워 프랜차이즈...	파이낸스투데이
소자본창업 전문 '두찜(두마리찜닭)', 남다른 배달 노하우 앞세워 프랜차이즈...	파이낸스투데이
행동하는프로라이프, 낙태죄 개정안의 문제점과 대안 제시한다	크리스천투데이
“엄청 세게 쳐도...” 제시 가슴 수술한 의사가 한 말	위키트리
"안녕 난 던이라고 해"…던, ♥현아·제시·싸이 응원 속 컴백(종합)	조이뉴스24
강남세브란스병원, "유전체 분석으로 암 맞춤 치료법 제시한다"	한국경제TV
던(DAWN) “현아, ‘던디리던’ 응원→제시 뮤비 출연 감사”	MK스포츠
'놀면 뭐하니' 환불원정대 제시, 마지막 녹음주자…라도와 의견 충돌? [포인트...	엑스포츠뉴스
나는 절대 안 꿀려 So~ 제시	topclass
안호영 의원, '새만금 수질 평가 및 개선방향 제시를 위한 연구용역 보고서' ...	전북도민일보
'옥문아' 제시가 생각하는 센 언니? 박나래.."그냥 힘이 세다"	스타뉴스
던 11개월 만에 컴백…"제시·싸이·현아, 든든"	디지털타임스
'컴백' 던, 미니 1집 샘플러 공개…싸이·제시·크러쉬까지 '든든한 지원사격...	스포츠조선
경북보건환경연구원 이기창 박사, 우라늄 오염 지하수 해결법 제시 '눈길'	경북일보
[SE★현장] 싸이·제시 전폭적 지지 받은 던, 男 솔로 아티스트 자리매김할까...	서울경제
드림촌 재개 위해 민관협 카드 제시	인천일보
"전문변호사로서 길을 제시" 김한근 변호사 '건설분쟁실무' 출간	중부매일
'인기가요' 박진영 vs 제시 vs 블랙핑크, 1위 후보 격돌	스타뉴스
제시, 넘사벽 피처링 무대[포토엔HD]	뉴스엔
이재명, 공공배달앱 청사진 제시…“정부의 한국형 뉴딜, 경기도에서 디지털 ...	뉴스투데이
시뮬레이션 결과 제시하는 권성동 의원	뉴시스
박준배 김제시장, 국감서 새만금 수질 및 악취 개선 방법론 제시	전라일보
던, 타이틀곡 '던디리던' MV 티저 공개…제시 피처링 참여 '눈길'	컨슈머타임스
[DG증권] 하나금융지주, 업종 내 최선호주로 제시	데일리그리드
[커튼콜]던, 싸이·제시 지원사격 속 `던디리던` 컴백…또 하나의 색을 찾다	매일경제
채리나 "'왜 불러' 때 남편은 중학생"…걸크러시 대세 제시엔 "만나보고파" (...	마이데일리
조길형 시장, '자연과 생활이 조화로운 품격 있는 도시' 제시	브레이크뉴스
[BbCONF] 코로나19 시대 브랜드 전략 제시한 '브랜드비즈 컨퍼런스 2020'	비즈한국
與, 공정경제3법 처리 정주행…"재계, 납득할 만한 대안 제시 못해"	뉴스핌
제시 "미국서 인종 차별 당해. 책상 엎고 울었다"	텐아시아
인터 밀란, 라우타로 이적 시 아구에로 영입… 연봉 최대 108억 제시	스포탈코리아
'컴백' 던 "제시 '던디리던' 피처링, 든든한 지원군 느낌"	한국경제
'옥문아들' 제시, 이효리·유재석·싸이 '황금 인맥'→美인종차별 극복 방법…...	스포츠조선
‘옥문아’ 제시 “동양인이라고 왕따 당해 책상 엎어”	스포츠동아
싱어송라이터 던, 미니 1집 타이틀곡 ‘던디리던 (Feat. 제시)’ M/V 티저 공...	한국경제TV
장동윤, ‘식스센스’ 전소민-제시-미주와 물오른 촉 자랑	MBC연예
제시 가슴 수술 고백에 ‘옥문아’ 초토화 “실리콘 엄청 세게 쳐도 안터진다...	세계일보
'옥문아들' 제시, 김용만에 "뭐하시는 분이세요?"...허당매력 분출	한국경제
"'위드 코로나' 마이스 플랫폼으로" 대구 엑스코 비전 제시	매일신문
[포토] 제시, 던무대 열정 폭발	일간스포츠
'반값 배터리' 제시한 테슬라…국내 업체 기대·긴장 교차	연합뉴스언론사 선정
의대생 국시 난망에 전공의들 "정부, 의사 부족 대안 제시하라"	연합뉴스언론사 선정
송하진 전북도지사, '지역균형 뉴딜'과 '전북형 뉴딜'을 위한 정책제언 제시	매일일보
충남도의회, 청년농업인·보건지소 중심 통합돌봄 방안 제시	당진신문
[포토] 제시 '센언니의 카리스마 무대'	세계일보
표류 시뮬레이션 결과 제시하는 권성동 의원	뉴시스
김승남 의원, 농가소득 창출…영농형태양광 필요성 제시	프레시안
'옥탑방의 문제아들' 제시 "EXID ‘위아래’ 원래 내 곡이었다" 비화 공개	서울경제
전남대, ‘가상현실’ 활용한 진로교육~비대면 학습환경 제시	위키트리
“도쿄 가려면” 김학범 감독 가이드라인 제시	데일리안
언론노조, 포털 개혁 등 국정감사 4대 요구안 제시	오마이뉴스
[SC핫포커스]롯데-NC-삼성 '낙동강 교육리그', KBO 새 패러다임 제시?	스포츠조선
던 "제시 아우라 대단…든든한 지원군"	매일경제
이기창 박사, 우라늄 오염 지하수 정화방법 제시	대경일보
제시, '식스센스' 육감왕 1위 등극···2위 유재석·3위 오나라	서울경제
대전 중구, 내년도 구정방향·주요사업 청사진 제시	중부매일
해경, 피살 공무원 '월북' 근거로 '도박 빚' 제시…"2억 넘는다"	한국경제언론사 선정
10CM, 공연형 아티스트의 온라인 콘서트 방향성 제시 “라이브 뮤비 같은 3시...	뉴스엔
'인기가요' 박진영vs제시vs블랙핑크, 10월 둘째주 1위 트로피 두고 대격돌	헤럴드POP
마이다스아이티, 'CIM 퍼스트무버' 개최하며 대한민국 BIM기술의 세계표준 제...	뉴스프리존
던, 오늘(9일) '던디리던' 컴백..싸이·제시·크러쉬 지원사격	스타뉴스
‘식스센스’ 또 하나의 묘미, 육감王 맞추기…제시 1위 유지하나	스포츠동아
콧속 물혹 발병 원인 규명, 새 치료법 제시	메디컬월드뉴스
[어게인TV] '옥문아들' 제시가 말하는 환불원정대X유재석X싸이... "효리 언니...	헤럴드POP
‘옥문아들’ 제시 “이효리, 환불원정대 멤버 중 가장 리더십 있어”	뉴스엔
'식스센스' 장동윤X제시X전소민X미주, 가짜 식당 찾기 성공 [종합]	OSEN
소유 합류, ‘캡틴’ 티저 공개…이승철·제시와 케미 예고	스포츠동아
[포토] 던과 함께하는 제시 무대	일간스포츠
[종합]"♥현아-싸이-제시 든든한 지원군"‥던, 11개월만 공들여 강렬 컴백	헤럴드POP
'던디리던' 던, 오늘(9일) '뮤직뱅크' 출격..제시 지원사격	스타뉴스
제시 "과거 가슴 수술…누가 엄청 세게 쳐도 안 터진다고" 폭소 ('옥탑방의 문...	마이데일리
[특징주]한양증권우 주가 연일 가파른 상승세 "한양증권 엔지켐생명과학 투자...	충청리뷰
제시, 카메라도 뒷걸음 칠 카리스마[포토엔HD]	뉴스엔
'전지적 참견 시점' 제시부터 오마이걸까지, 웃음+감동 '쌍끌이'	텐아시아
제시 "연예인 중 가장 센언니? 박나래"…이유 보니	머니투데이
경북보건환경硏 이기창 박사, 우라늄 오염 지하수 해결방법 제시	경북매일신문
펠로시 "대선 전 부양책 합의 '48시간 데드라인' 제시..월요일 므누신과 대화...	한국금융신문
착시 누드톤 시스루→파격 가슴 절개…화사&제시, 이래서 환불원정대	스포티비뉴스
경찰, "공수처법 개정안 일부 수정해야" 입장 제시	YTN
"빅히트, 엔터계 지각변동 주도…목표가 21만2000원 제시"-이베스트투자증권	데일리안
제시, 참여지수 하락했지만 순위 다섯 계단 상승... 2020년 9월 가수 브랜드평...	미래한국
싸이, 던(DAWN) 미니 1집 타이틀곡 ‘던디리던 (Feat. 제시)’ 프로듀싱	스포츠경향
충남도의회, 청년농업인·보건지소 중심 통합돌봄 방안 제시	동양일보
이재명 경기도지사, 공공배달앱 청사진 제시	브레이크뉴스
주호영 "文대통령 '먹튀'할 것 아니면 빚 갚을 계획 제시하라" [전문]	한국경제언론사 선정
제3회 파주건축문화제, 23일 개막...'경계를 넘어' 파주시 NEW 공간 제시	CNB뉴스
[SC리뷰] "유재석=배우고픈 선배, 이효리=최고 리더"..'옥문아들' 제시 예능 ...	스포츠조선
제시 “계란 얼려라” 오나라에 난자 냉동 추천 ‘식스센스’[결정적장면]	뉴스엔
'옥탑방의 문제아들' 제시 "10대 시절 동양인이라는 이유로 놀림 당해"	한국경제
'전참시' 제시, 센 언니? 가족사진에 폭풍 '눈물'	텐아시아
한신투자그룹, ‘관리-신뢰-안정’ 기반의 투자 패러다임 제시	아시아타임즈
‘전참시’ 제시, 이런 모습 처음…가족사진에 폭풍 눈물	스포츠동아
제시, 美인종차별 일화 보니?	머니S
한신투자그룹, ‘관리-신뢰-안정’ 기반의 투자 패러다임 제시	아시아타임즈
식물공장의 규격화 모델 제시를 위해	월간원예
제시, 쎈언니 카리스마 속 러블리 매력[포토엔HD]	뉴스엔
‘놀면 뭐하니?’ 제시vs김종민, 세기의 진흙탕 케미 (ft.환장)	스포츠동아
'쇼터뷰' 제시-임창정, 할리우드 진출 계획? "반 갈라, 나랑 계약해"	톱스타뉴스
제시 사로잡은 ‘미우새’ 누구? 직진녀 고백	스포츠동아
던(DAWN), 미니 1집 타이틀곡 ‘던디리던(Feat. 제시)’ 리릭 티저 공개	한국경제TV
송하진 도지사, 지역균형 뉴딜과 전북형 뉴딜 위한 정책제언 제시	위키트리
[DA포토]던-제시, 던디리던 환상 호흡	스포츠동아
2020 오대산 문화포럼 '비대면 시대 새로운 방향 제시'	BBS NEWS
던, 제시-크러쉬부터 싸이까지..든든한 지원사격 속 9일 '던디리던' 컴백	헤럴드POP
세종 저상버스 운행 개선·확대 도입안 제시	중도일보
[종합] '놀면뭐하니?' 이효리X엄정화X제시X화사, 환불원정대 'DON'T TOUCH ME...	톱스타뉴스
충주시의회 최지원 의원, 수안보 관광활성화 대안 제시	충청투데이
제시 “EXID ‘위아래’ 원래 내 곡…내가 먼저 녹음”(옥탑방의 문제아들)	MK스포츠
'식스센스' 장동윤 "제시 누나 만나보고 싶다"	엑스포츠뉴스
살 빠진 이효리, 제시 앞에서 잘록 허리 뒤태 자랑	여성조선
[사진]'던디리던'으로 돌아온 던, '제시와 콜라보'	OSEN
MS·구글에도 없는 ‘AI 데이터 품질 표준안’…韓 먼저 제시	머니투데이
민주, ‘공수처 시한’ 제시…“국감 끝나기 전 공수처장 추천위원 추천해달라...	KBS
“♥현아 많이 응원해줘” 던, 제시·크러쉬·싸이 손잡고 흥할까(종합)	뉴스엔
전주 옛대한방직부지 방향성 제시할 시나리오 워크숍 시작	전민일보
문진석 의원 , '스마트 명품 천안역'비전 제시	내외뉴스통신
정부, 재정건전성 기준 국가채무 GDP 60%·통합재정수지 -3% 제시	브릿지경제
제시, 성형 수술 반대? "5년 전 맞은 필러…다 녹였다"	뉴스컬처
블록체인 등 디지털 자산 시장 활성화…KDFT, 포렌식 응용 솔루션 제시	뉴스1
[N컷] '전참시' 제시, 가족사진 보고 눈물 흘린 사연 '뭉클'	뉴스1
라온시큐어, DID플랫폼간 상호호환 해법 제시…"옴니원에 GADI 연결"	아주경제
'환불원정대' 엄정화·이효리·제시·화사, 'DON'T TOUCH ME' 갬성 녹음샷 대...	엔터미디어
DGB대구은행, 임성훈 은행장 취임…경영 기본원칙 3가지 제시	경북일보
'어서와' 제이슨, 덕계못 깨고 봉준호 감독 친필 메시지 받아…"새로운 시점 ...	TV리포트
임영웅 '뽕숭아학당'서 제시의 '눈누난나' 댄스 챌린지 공개	톱데일리
[기자수첩] E정책 현안 짚고 대안 제시하는 국감되길	투데이에너지
던, 미니 1집 타이틀 ‘던디리던(Feat. 제시)’ 뮤비 티저	뉴스엔
[포토] 제시, 던 솔로무대 축하 하러왔어요	일간스포츠
싸이, 던 신곡 '던디리던 (Feat. 제시)' 프로듀싱…'든든 지원사격'	마이데일리
'식스센스' 정용화, 제시X미주 거침없는 입담에 '진땀'	엑스포츠뉴스
[S포토] 제시, 'Jessi is so hot'	스타데일리뉴스
[DA포토]제시, 팡팡 터지는 걸크러시 매력	스포츠동아
'전지적 참견 시점' 제시, 가족사진에 폭풍 오열한 사연	이데일리
美백악관 추가 부양책 제시에 코스피·코스닥 상승 출발	조선비즈
[DA포토]제시, 던 지원사격.. 걸크러시 매력	스포츠동아
KB증권, ‘KB able 미국대표성장주랩’ 출시…리서치센터 제시 美주식 포트폴...	더퍼블릭
[자비순례 7일째]'치밀한 방역에 건강 체크까지'…이상적 순례 제시	법보신문
'옥문아들' 제시 "이효리 제일 리더십 있다, 진짜 센 언니는 박나래"	MBN
넥스모스, 윈트(Wnt)신호개선 탈모완화 가능성 제시	약업신문
이기창 경북보건환경硏 박사 지하수 우라늄 흡착방식 제시 눈길	경북도민일보
엄태준 이천시장, 지역경제 활성화 방안 제시	머니S
