클라라, 목욕하면서도 셀카…“피부 인정” [SNS는 지금]	스포츠경향
클라라, 농염한 드레스 자태…눈맞춤에 '심쿵' [데일리SHOT]	마이데일리
클라라, 샤워가운도 없이 욕조 속 셀카…'파격+섹시' 쇄골라인	스포츠조선
마스크로 얼굴 가리기? 클라라 얼굴 얼마나 작길래 [★해시태그]	엑스포츠뉴스
클라라, 머리 날리고 입술 내밀고‥스타의 혼자 놀기[SNS★컷]	뉴스엔
클라라, 욕실 셀카 시선집중…섹시한 눈빛에 `심쿵`	매일경제
'방금 샤워했어요~' 클라라, 쇄골 노출한 채 섹시 美 발산 [★SNS]	스포츠서울
클라라, 이제는 목욕하면서까지 셀카를..근데 예쁘긴 예쁘다	헤럴드POP
클라라, 목욕 중 머릿 수건 올리고 찰칵...쇄골+뽀얀 피부 시선강탈 [M+★SNS...	MBN
클라라, 머리 수건 말고 가녀린 쇄골 노출… 청순美 발산 [SNS★컷]	뉴스엔
클라라, 목욕 중 머릿 수건 올리고 찰칵...쇄골+뽀얀 피부 시선강탈 [M+★SNS...	MBN
클라라, 파격적인 목욕 셀카…아찔한 쇄골+가는 목선 '눈길' [★해시태그]	엑스포츠뉴스
클라라, 보는 순간 깜짝 놀란 '착시 의상'…도발적 섹시美	스포츠조선
"착시?" 클라라,인형같은 이목구비로 청순+섹시美 [★SNS]	스포츠서울
클라라, 유부녀가 이렇게 예쁠 일? 앞머리 내리고 동안 미모 폭발	헤럴드POP
"바비 인형 강림"..클라라, 사람이야 인형이야 [스타IN★]	스타뉴스
클라라C, ’18 어게인’ OST PART7 참여…오늘(19일) ‘Somebody’ 발매	MK스포츠
클라라, 초근접 밀착샷도 굴욕 無…'셀카 찍을 맛 나겠네'	마이데일리
리뷰 | ‘페뷸러스’ 기막히게 멋진 여성들의 유쾌한 우화	맥스무비
클라라, 결혼하고 매일이 리즈..앞머리 내리고 인형 비주얼[스타IN★]	스타뉴스
[인터뷰]'바이올린 전공' 류보리 작가 "브람스, 현실적? 제 경험담은 아냐"	뉴시스
클라라, '인어공주'의 환생?…감탄 절로 나는 수중 화보	마이데일리
클라라, 몽환적인 요정美…어딘가 달라진 외모 ‘눈길’	스포츠조선
클라라, 나라도 자랑하고 싶을 개미허리..♥남편은 정말 좋겠네	헤럴드POP
클라라, 몽환 눈빛에 육감적 볼륨감 자랑 ‘섹시美 대방출’[SNS★컷]	뉴스엔
클라라, 올백머리+크롭탑으로 뽐낸 극강의 섹시美 [SNS★컷]	뉴스엔
클라라, 입술 쭉 애교 섹시해..결혼 후 나날이 미모 리즈 갱신	헤럴드POP
알라메다, 산타클라라카운티 실내영업 가능해졌다	미주중앙일보
[단독]내부 고발자 색출하고 교육청까지 고소한 이규태 회장	노컷뉴스언론사 선정
산타클라라 카운티 부동산 총평가액 5천515억달러	미주한국일보
일광 이규태, 회삿돈도 모자라 유치원 돈까지 가로챘나	노컷뉴스
클라라, 결혼하더니 미모 더 물올랐어..이목구비가 화려함 그 자체	헤럴드POP
[Review] 내 세상은 SNS 화면보다 커 - 페뷸러스	아트인사이트
[Review] 유쾌하고 사랑스러운 영화, 페뷸러스	아트인사이트
클라라, 컬러렌즈로 더한 매혹적 비주얼..글래머 몸매 원톱	헤럴드POP
클라라, 햇살 가득 미모에 시선 고정...'예쁨주의'	뉴스컬처
클라라, 도자기같은 '백옥피부'…무결점 미모에 '깜짝'	한국경제TV
천주교인 1000명 "신자인 저도 낙태죄 전면폐지를 원합니다"	경향신문
클라라, 섹시 벗고 극강 청초美…클로즈업 할수록 돋보이는 미모	스포츠조선
섹시 美 뽐내는 '레깅스 여신' 클라라의 자태 [★SNS]	스포츠서울
유치원 돈 가로챈 혐의 일광 이규태…"예산책임자는 원장" 반박(종합)	노컷뉴스
클라라, 인형이야 사람이야‥도톰 입술 뽐낸 ‘치명적 섹시함’[SNS★컷]	뉴스엔
클라라, 168cm·48kg의 쇄골 라인…무결점 피부로 뽐낸 고혹美	스포츠조선
클라라, 질투나는 명품 콧대 자랑…결혼하더니 사랑 듬뿍 받나봐	헤럴드POP
천상계 비주얼…클라라, 초밀착샷도 결점 無 [데일리SHOT]	마이데일리
클라라, 그림자까지 러블리하네…물오른 비주얼에 심쿵	헤럴드POP
[Review] '좋아요' 시대의 우정 - 페뷸러스 [영화]	아트인사이트
클라라, 초근접 셀카는 더 예뻐 ‘극강 청순美’[SNS★컷]	뉴스엔
클라라, 애플힙+개미허리 최강 S라인 ‘역시 레깅스퀸’	매일경제
19. 슈만의 피아노 음악	법보신문
클라라, 물 고일 듯한 쇄골 자랑..반박불가 섹시스타 정석	헤럴드POP
클라라, 브라탑+레깅스 사이로 11자 복근 `S라인 매력 발산`[똑똑SNS]	MK스포츠
클라라, 반박불가 美친 글래머..평생 관리하는 이유	헤럴드POP
클라라, 우아함에 고혹미까지…세상 혼자 사는 미모 [데일리SHOT]	마이데일리
엔비디아, ‘클라라 연합학습’으로 AI 모델 구축…“코로나19 환자 산소 요구...	CIO Korea
SC∙AL카운티 경제재개 3단계 격상	미주한국일보
공연 기획자가 만드는 VR은 무엇이 다를까? '진심' 강조하는 '쉐어박스'	IT동아
클라라, 남편은 정말 좋겠네..이 비주얼 전세계 1% 상위급	헤럴드POP
[Review] 다 잘될거야! YAASSSSSS! - 페뷸러스 [영화]	아트인사이트
[DAY컷] 클라라, 어느 각도에서도 굴욕 없는 늘씬한 몸매	스포츠동아
'미인도 뚫고 나왔나?' 클라라, 단아한 한복자태 [★SNS]	스포츠서울
[Review] 우정과 우리 사회를 유쾌하게 그려낸 영화 - 페뷸러스	아트인사이트
클라라, 예쁘긴 진짜 예뻐…단아한 한복자태에 그저 감탄 뿐	헤럴드POP
클라라, 브라톱·레깅스 입고 섹시美 폭발…'아찔 애플힙+육감적 볼륨감' [데...	마이데일리
'168cm·48kg' 클라라, 명절 음식도 안 먹었나 "평생 관리" [★SHOT!]	OSEN
[니가 사는 그책] "브람스를 좋아하세요?"라는 말에 담긴 의미	독서신문
클라라, 한복으로 더한 멋...'단아美 폭발'	뉴스컬처
의료계 종사자∙라틴계 다세대 가족들	미주한국일보
백건우 "젊었을 땐 불편하게 느꼈던 슈만, 이제서야 더 깊이 이해할 수 있게 ...	파이낸셜뉴스
[Review] 가볍게 즐기기 좋은 여성 코미디 영화: 페뷸러스[영화]	아트인사이트
클라라, 레깅스+탱크톱으로 뽐낸 완벽 몸매 ‘넘사벽 섹시미’ [SNS★컷]	뉴스엔
클라라, 방송 복귀한다…내달 '차이나피디아' MC	뉴시스
클라라, 물오른 미모…청순美	매일경제
클라라, 광고여도 받아보고 싶네…스파나선 자기 관리 끝판왕	헤럴드POP
클라라, 감탄 자아내는 탄탄 보디라인…아름다운 구릿빛 피부	헤럴드POP
길로이 대승사 ‘제2 이전불사’ 첫걸음	미주한국일보
클라라, 결혼 후 물오른 미모...`큐티섹시`	매일경제
클라라, 숏폼 콘텐츠 中서 3600만뷰…"믿기지 않았다"	뉴시스
교통사고 사망 한인 간호사 클라라 강씨 추모행사	미주중앙일보
[On Stage] "자가격리 동안 집중해 연습할 수 있어 좋았다"	아시아경제
[N샷] 클라라, 청초 미모 눈부신데 "피부 탄력 떨어져" 토로	뉴스1
손열음·클라라 주미강 듀오 전국투어	강원도민일보
클라라, 시크하고 청순하고 다하네..결혼 후 더 예뻐진 미모	헤럴드POP
클라라주미강·손열음 듀오, 제주서 무관객 온라인 공연	제주의소리
클라라, 인형 미모+늘씬 각선미	매일경제
[스브스夜] 박은빈, 김민재에 "브람스를 좋아하세요?"…'브람스X클라라X슈만'...	SBS funE
[동인문학상] 8월 독회 심사평 전문	조선일보
클라라, '청순+섹시美' 넘치는 어깨 라인…눈부신 자태	스포츠조선
[N샷] "군살 0%" 클라라, 어느 각도로 봐도 완벽몸매	뉴스1
클라라, 순정만화 비주얼..우월함 끝판왕	헤럴드POP
산타클라라 노인봉사회 추석 선물 배포	미주한국일보
클라라, 핫팬츠로 드러낸 완벽 각선미…"꽃보다 화려한 미모"	스포츠조선
클라라, 흑백 사진 속 우아美..."모든 여성은 아름답다"	매일경제
클라라, 완벽 보디라인 자랑 "love your self"	매일경제
배우 클라라 "경남제약" 다이어트 모델 확정... 국내활동 재개하나?	미래한국
클라라, 눈부신 여신 미모	매일경제
클라라, 초미니 원피스 입고 다리 꼬기 "아찔 각선미"	스포츠조선
클라라 근황, 돋보이는 애플힙…요염한 S라인 [똑똑SNS]	MK스포츠
팝페라 여성그룹 클라라의 축하공연 [MK포토]	MK스포츠
클라라, '비율 실화?' 살아있는 인형 미모	뉴스컬처
클라라, 감탄 자아내는 탄탄 보디라인…아름다운 구릿빛 피부	헤럴드POP
클라라 복귀, 결혼 후 첫 한국 방송 진행…中 정보 나눈다	한국경제
길로이 대승사 ‘제2 이전불사’ 첫걸음	미주한국일보
코로나19 환자 산소 요구량 예측하는 AI 모델	디지틀조선일보
클라라, 결혼 후 물오른 미모...`큐티섹시`	매일경제
클라라, 숏폼 콘텐츠 中서 3600만뷰…"믿기지 않았다"	뉴시스
클라라, 11자 복근+S라인 완벽 골반 라인… 명품 몸매 인증 [SNS★컷]	뉴스엔
교통사고 사망 한인 간호사 클라라 강씨 추모행사	미주중앙일보
[On Stage] "자가격리 동안 집중해 연습할 수 있어 좋았다"	아시아경제
[N샷] 클라라, 청초 미모 눈부신데 "피부 탄력 떨어져" 토로	뉴스1
[On Stage] "자가격리 동안 집중해 연습할 수 있어 좋았다"	아시아경제
[N샷] 클라라, 청초 미모 눈부신데 "피부 탄력 떨어져" 토로	뉴스1
손열음·클라라 주미강 듀오 전국투어	강원도민일보
클라라, 시크하고 청순하고 다하네..결혼 후 더 예뻐진 미모	헤럴드POP
클라라, 섹시미 가득 완벽 몸매…레깅스퀸의 귀환	MBN
클라라, 윙크&뽀뽀 러블리 애교로 심쿵	스타뉴스
클라라주미강·손열음 듀오, 제주서 무관객 온라인 공연	제주의소리
클라라, 인형 미모+늘씬 각선미	매일경제
[스브스夜] 박은빈, 김민재에 "브람스를 좋아하세요?"…'브람스X클라라X슈만'...	SBS funE
[B그라운드] 슈만의 재발견, 피아니스트 백건우 “어려움 속에서도 살아있고 ...	브릿지경제
클라라, 인형 미모+늘씬 각선미	매일경제
클라라, 꽃받침+뽀뽀쪽‥♥남편 무장해제 시키는 애교	헤럴드POP
[스브스夜] 박은빈, 김민재에 "브람스를 좋아하세요?"…'브람스X클라라X슈만'...	SBS funE
[B그라운드] 슈만의 재발견, 피아니스트 백건우 “어려움 속에서도 살아있고 ...	브릿지경제
클라라, 여전한 청순+섹시 자태…핑크&그린 환상 조합	스포츠조선
[동인문학상] 8월 독회 심사평 전문	조선일보
클라라주미강 & 손열음 듀오 리사이틀	뉴스제주
클라라, '청순+섹시美' 넘치는 어깨 라인…눈부신 자태	스포츠조선
[N샷] "군살 0%" 클라라, 어느 각도로 봐도 완벽몸매	뉴스1
클라라, 순정만화 비주얼..우월함 끝판왕	헤럴드POP
산타클라라 노인봉사회 추석 선물 배포	미주한국일보
클라라, 핫팬츠로 드러낸 완벽 각선미…"꽃보다 화려한 미모"	스포츠조선
클라라, 새댁의 화사한 근황	미디어펜
클라라, 구릿빛 보디라인...`글래머 여전사` 포스	매일경제
클라라, 흑백 사진 속 우아美..."모든 여성은 아름답다"	매일경제
클라라, 동안 비결은 열혈 관리…나날이 미모 업그레이드	매일경제
클라라, 완벽 보디라인 자랑 "love your self"	매일경제
배우 클라라 "경남제약" 다이어트 모델 확정... 국내활동 재개하나?	미래한국
클라라 주미 강·손열음 듀오무대 온라인으로	서울경제
클라라, 눈부신 여신 미모	매일경제
클라라 주미 강·손열음 듀오무대 온라인으로	서울경제
클라라, 눈부신 여신 미모	매일경제
클라라, 레깅스+브라탑으로 과시한 美친 볼륨 몸매 "평생관리"	스타뉴스
클라라, 방송 복귀…중화TV '차이나피디아' MC	연합뉴스
클라라, 운동복 입고 뽐낸 복근+볼륨 몸매…"평생 관리" [데일리SHOT]	마이데일리
클라라, 초미니 원피스 입고 다리 꼬기 "아찔 각선미"	스포츠조선
클라라 근황, 돋보이는 애플힙…요염한 S라인 [똑똑SNS]	MK스포츠
팝페라 여성그룹 클라라의 축하공연 [MK포토]	MK스포츠
클라라, '비율 실화?' 살아있는 인형 미모	뉴스컬처
클라라 복귀, 화려한 비주얼...기대↑	매일경제
클라라 복귀, 화려한 비주얼...기대↑	매일경제
클라라, 머리부터 발끝까지 ‘보라색 홀릭’	스포츠조선
'인간 고무줄' 클라라…선 채로 웃으며 180도 다리찢기, 엄청난 유연성	뉴스1
[이주헌의 혁신@미술]<16> 공장식 공방서 생산→홍보→영업…'CEO 화가' 루벤...	이데일리
클라라, 결혼 후에도 변함없는 미모…치명적 애교 발산 [★해시태그]	엑스포츠뉴스
클라라, 이렇게 섹시해도 돼? 건강美 자랑 [똑똑SNS]	MK스포츠
'클라라 주미 강 & 손열음 듀오 리사이틀' 유튜브 생중계	파이낸셜뉴스
클라라, 핑크립으로 완성한 치명美..명불허전 섹시 스타	헤럴드POP
클라라, 머리 붙이고 청순美UP‥말도 안되는 각선미	헤럴드POP
클라라, 운동으로 다져진 탄탄한 복근 '명품 보디라인'	마이데일리
클라라, 운동으로 다져진 탄탄한 복근 '명품 보디라인'	마이데일리
클라라, 앞머리 강조한 트렌디 세터…청순 섹시란 이런 것	헤럴드POP
무료 코로나19 테스트 센터 교회에도	미주한국일보
클라라, 블랙 원피스 아찔 각선미 `섹시美`	매일경제
클라라 주미 강·손열음 듀오 리사이틀 4일 온라인 생중계	아이뉴스24
클라라, 파란색 긴 생머리로 뽐낸 몽환美…청순·섹시 매력	마이데일리
오피스 서브리스 공실률 ↑	미주한국일보
클라라, 흑백 뚫는 우아+고혹美…독보적 보디라인 [★해시태그]	엑스포츠뉴스
클라라, 관리 받고 얼굴 달라졌나 "동안 얼굴 만드는 중" [★해시태그]	엑스포츠뉴스
클라라, 바비인형 아냐? 결혼 후 더 예뻐진 미모 자랑[SNS★컷]	뉴스엔
클라라 '여성 지지 연대 챌린지' 동참…"모든 여자는 아름다워♥"[★SNS]	스포츠서울
클라라, 치명적인 우아미..얼굴이 커피잔만 해	헤럴드POP
"브람스를 좋아하셔요"	경남매일신문
[DAY컷] 클라라 “점점 피부탄력 떨어져”…고충 토로	스포츠동아
클라라, 장미꽃보다 시선가는 미모..물오른 고혹적 자태	헤럴드POP
'168cm·48kg' 클라라, 86년생 대표 섹시 트로이카 [★SHOT!]	OSEN
클라라, 한 뼘 핫팬츠 입고 늘씬 각선미 과시 [똑똑SNS]	MK스포츠
클라라, 섹시 애플힙으로 완벽 S라인 자랑…다이어트 자극	헤럴드POP
클라라, 덕분에 챌린지 동참 "코로나19 극복에 보탬 될 것"	텐아시아
"명품백 메고, 강렬 눈빛"…클라라 근황, 화려한 패션감각	마이데일리
"명품백 메고, 강렬 눈빛"…클라라 근황, 화려한 패션감각	마이데일리
클라라 '돋보이는 미모'	뉴스1
클라라, 질투 부르는 여신…'결혼하고 나날이 예뻐져'	마이데일리
클라라, 아름다운 풍경 속 뽐낸 명품 보디라인	매일경제
'브람스' 박은빈, 김민재에 "사랑해요" ...커플링 미래 약속 '해피엔딩'	한국경제
클라라, 180도 다리 찢기에 깜짝…감탄 자아내는 유연성	마이데일리
클라라 챌린지 동참 "덕분에…존경, 감사합니다"	매일경제
클라라 국내활동 복귀? 경남제약 컷앤컷다이어트 모델 발탁!	Queen
클라라 주미 강·손열음 듀오 리사이틀 유튜브 온라인 생중계	아시아경제
클라라, 클로즈업에도 '굴욕無'…이 미모 실화?	마이데일리
'도심 속 요정' 클라라, 나비에 둘러싸여[★SNS]	스포츠서울
클라라, 초미니 원피스로 뽐낸 아찔 각선미	스타뉴스
클라라, 초록색 투톤도 찰떡 소화…완벽 몸매는 덤 [SNS★컷]	뉴스엔
클라라 '눈부신 미모'	뉴스1
클라라 '품절녀 인증 반지'	뉴스1
클라라 '미소가 아름다워'	뉴스1
클라라 '앞치마도 잘 어울려'	뉴스1
클라라 '파이팅도 아름답게'	뉴스1
클라라 주미 강& 손열음의 듀오 리사이틀, 4일 크레디아TV서 무료 생중계	스포츠서울
클라라, 탱크톱으로 뽐낸 볼륨감…명품 쇄골은 덤 [★해시태그]	엑스포츠뉴스
클라라, 챌린지 동참 “생활 속 작은 실천으로 작은 보탬이 되겠다”	스포츠동아
클라라 "having #afternoontea" 카페서 즐긴 일상의 여유	인천일보
클라라 미모 폭발, 일상이 화보	매일경제
산타클라라 테니스클럽 여성 대회	미주한국일보
(구미) 비대면으로 찾아가는 클라라 주미 강 & 손열음 듀오 리사이틀	현대HCN 새로넷방송
클라라, '차이나피디아' MC로 방송 복귀…7월26일 첫방	뉴스1
클라라, 핫팬츠로 뽐낸 늘씬 각선미…매혹적 자태 '심쿵' [★해시태그]	엑스포츠뉴스
[DAY컷] 클라라, 잘록한 한줌허리…대체불가 미모	스포츠동아
‘클라라 주미 강 & 손열음 리사이틀’ 오는 4일 유튜브 라이브 진행	플레이디비
클라라 '아름다운 손인사'	뉴스1
클라라 '화이트 & 블랙의 조합'	뉴스1
클라라 “숏폼 콘텐츠 3600만 조회수+中 연예인 4위, 믿기지 않더라”	뉴스엔
클라라, 이 섹시美 어쩔?…탱크톱 입고 볼륨감 과시	마이데일리
"걸어다니는 인형"..클라라, 거침없는 냉미녀 포스…웃는 게 이렇게 예쁜데	헤럴드POP
클라라, 하의실종룩으로 뽐낸 美친 미모+8등신 비율[SNS★컷]	뉴스엔
클라라, 늘씬 각선미에 시선 고정...'비율 천재'	뉴스컬처
클라라 복귀, `차이나피디아` MC로 한석준과 호흡	매일경제
[클래식, 기억하다] 쓸쓸하지만 숭고한 음악, 가을에는 브람스를 기억하세요	문화뉴스
중화TV ‘차이나피디아’ MC 한석준-클라라-이독실 MC확정 [공식]	스포츠동아
클라라, 컬러 렌즈로 인형 비주얼 완성 ‘사람 맞나’ [SNS★컷]	뉴스엔
클라라, 관리하는 여자의 뒤태 클라쓰…넘사벽 '애플힙' [★해시태그]	엑스포츠뉴스
클라라, 상큼 가득 꽃받침...'미소는 덤'	뉴스컬처
클라라, 결혼하고 더 예뻐진 '한 폭의 그림같은 비주얼'	스포츠조선
클라라, 게임 캐릭터 같은 美친 비주얼…블리치+블루렌즈도 찰떡	마이데일리
클라라 '좋은 일에 함께 해요!'	뉴스1
클라라, 머리부터 발끝까지 보라...초미니 `몽환 드레스`	매일경제
클라라, 오묘한 컬러렌즈로 완성한 예쁨…꽃잎을 머금은 듯한 립은 거들 뿐	헤럴드POP
클라라, 아름다운 꽃미모 자랑	스타뉴스
클라라, 보는 이가 더 아픈 180도 다리 찢기 ‘유연성 최고’ [SNS★컷]	뉴스엔
‘한밤’ 클라라, 숏폼 콘텐츠 중국서 대박 “나도 안 믿겨”	스포츠동아
클라라, 디자이너 이청청과 투샷..훈훈	스타뉴스
클라라 주미 강·손열음, 9월 듀오 리사이틀	연합뉴스
클라라, 밀착 브라톱+레깅스 매치…독보적인 건강미	머니투데이
클라라, 사람인지 인형인지 헷갈리는 '여신' 비주얼 [★해시태그]	엑스포츠뉴스
클라라, 사이버틱 헤어+빨간 입술 ‘미모는 어떤 변신도 오케이’ [SNS★컷]	뉴스엔
클라라, ‘덕분에 챌린지’ 동참 “진심 어린 감사와 존경” [똑똑SNS]	MK스포츠
핫핑크 운동복으로 S라인 뽐낸 클라라…“난 더 할 필요가 있어”	세계일보
클라라, 인형같은 비주얼에 숨멎…심쿵유발 매혹적 눈맞춤	헤럴드POP
클라라, 사랑의 기부 챌린지 동참…"선한 영향력 발휘되길"[★SNS]	스포츠서울
[비바100] ‘아베크 변주곡’부터 ‘유령 변주곡’까지…극과 극 슈만, 백건우...	브릿지경제
[비바100] ‘아베크 변주곡’부터 ‘유령 변주곡’까지…극과 극 슈만, 백건우...	브릿지경제
클라라, '잘록한 허리'로 완성한 패셔니스타…"화보 찍는 줄"	스포츠조선
클라라, 레깅스 입고 요염한 포즈…'섹시美' 보디라인	스포츠조선
"모든 여성은 아름답다"…클라라, 흑백 사진 속 우아한 자태	MBN
클라라, 유부녀 안 믿기는 美친 각선미..화려함의 극치	헤럴드POP
클라라, 완벽 레깅스 자태 "나홀로 짐에"	매일경제
역시 숏폼 콘텐츠 능력자 헨리·클라라…'한밤' 제작과정 전격 공개	아이뉴스24
노벨문학상 작가 가즈오 이시구로 신작 '클라라와 태양' 내년 봄 출간	뉴스1
클라라 챌린지→최진혁‧정아 지목 “작은 보탬이 될 수 있길” [M+★SNS]	MBN
클라라, 커피잔보다 작은 얼굴 크기…'소두' 여신 미모 [★해시태그]	엑스포츠뉴스
클라라, 이기적인 이목구비…섹시함이 한도 초과 [★SHOT!]	OSEN
새댁 클라라, 남심 저격 늘씬 자태…11자 각선미가 그저 감탄뿐	헤럴드POP
클라라, 섹시 춤선+윙크에 남심 초토화..결혼하더니 더 예뻐졌어	헤럴드POP
클라라, 러블리 에너지 뿜뿜...'하트는 덤'	뉴스컬처
클라라, 양갈래+레깅스..만화 주인공 같은 비주얼	스타뉴스
[뉴스체크｜문화] 클라라 주미 강·손열음 콘서트	JTBC
클라라도 '덕분에 챌린지' 동참 "의료진 헌신에 감사드려요" [★SNS]	스포츠서울
클라라, 틱톡 영상으로 중국서 3600만뷰 대박난 근황 "갈 길 멀어"	스포츠한국
숨겨지지 않는 볼륨감, 클라라의 일상스타그램 [★SNS]	스포츠서울
클라라, 폭발하는 섹시美 '진짜 S라인'이 여기 있구나	서울경제
클라라, 만화에서 튀어나온 듯한 비주얼…"혼자 놀기"	마이데일리
첫방 '브람스를 좋아하세요' 볼 만 해? 시청자 감성 정조준	한국경제
클라라, 녹슬지 않은 아름다움…결혼 후에도 여전한 S라인	헤럴드POP
클라라, 국내 방송 복귀…'차이나피디아' 메인 MC 확정 [공식]	텐아시아
클라라, 심쿵 부르는 윙크…이러니 안 반해?	마이데일리
클라라, 만찢미모 인증 "순정만화 주인공, 동안얼굴 되고 싶어요"	헤럴드POP
클라라, 이토록 섹시한 쇄골이라니!	매일경제
'새댁' 클라라, 결혼 후 물오른 미모…파격 스타일 시도 [★해시태그]	엑스포츠뉴스
클라라 주미 강ㆍ손열음 듀오 리사이틀, 4일 유튜브 생중계	서울문화투데이
클라라, 탱크톱으로 뽐낸 섹시미	미디어펜
클라라, 탱크톱으로 뽐낸 섹시미	미디어펜
"코로나19 극복에 보탬될 것" 클라라, '덕분에 챌린지' 동참	마이데일리
클라라 is 뭔들…'힙한' 스타일도 찰떡 소화	마이데일리
클라라, 유연성이 이 정도야? 선 채로 웃으며 180도 다리찢기[★SHOT!]	OSEN
클라라, 섹시 대신 러블리..순정만화 여주 같은 청순 비주얼[★SHOT!]	OSEN
클라라, 헬스장 근황 공개.."천상 연예인"	스타뉴스
[공식]중국 인문학 토크쇼 '차이나피디아', 한석준X클라라X이독실 MC 확정	스포츠조선
[MJ포토] 팝페라그룹 클라라, '천상의 음색'(미스그랜드코리아)	문화저널21
클라라, 명불허전 섹시 아우라..꽃도 기 죽일 화려 미모	헤럴드POP
클라라도 '덕분에 챌린지' 참여..다음 주자 최진혁 지목	스타뉴스
클라라도 '덕분에 챌린지' 참여..다음 주자 최진혁 지목	스타뉴스
클라라, 더위 날리는 고혹적 미모…인형이 따로 없네 [★해시태그]	엑스포츠뉴스
클라라, 결혼하더니 더 섹시해..잘록 개미허리+화려한 골반라인	헤럴드POP
클라라 주미 강 "반년간 공연 취소…무대가 그리웠죠"	연합뉴스
클라라 "거울 닦기 챌린지" 리즈 갱신 셀피 한 컷	인천일보
'방송복귀' 클라라, 여유로운 일상...'커피잔보다 작은 얼굴'[★SNS]	스포츠서울
클라라 "#flexibility" 틱톡 놀이 삼매경 들여다보니?	인천일보
클라라, 레깅스 입고 180도 다리 찢기...인간 고무줄 '깜짝'	스포츠조선
클라라, 슬립 한 장만 입어도 우아함이 뚝뚝..흑백의 아우라	헤럴드POP
클라라 "#summer" 여신 아우라 과시 셀피 한 컷	인천일보
'브람스를 좋아하세요?' 첫방부터 터졌다 '최고 시청률 7% 돌파'	스포츠조선
쇄골미인 클라라, 노출+각도에 '섹시美 대폭발' 명품 몸매는 덤	서울경제
클라라, 핫팬츠로 뽐낸 다리길이…"여기 너무 예쁘다"	머니투데이
클라라, 앉아만 있어도 완벽한 S라인…치명적인 매력	마이데일리
클라라, 더듬이 머리도 찰떡 소화…힙&청순	마이데일리
클래식계 '젊은 거장' 클라라주미강‧손열음 제주에	뉴제주일보
클라라, 할 말 잃게 만드는 여신 미모	미디어펜
클라라, 유부녀가 이렇게 섹시할 일? 눈빛만 봐도 매혹적	헤럴드POP
클라라, 매혹적 윙크…어느 각도에서도 예뻐 [★해시태그]	엑스포츠뉴스
클라라, 선 채 180도 다리찢기...놀라운 유연성 `깜짝`	매일경제
클라라 "#healthylifestyle" 여전한 여신 아우라	인천일보
클라라, 사람인가 게임 캐릭터인가[★SHOT!]	OSEN
클라라, '거울 닦기 챌린지' 참여…청순+섹시 팔색조 매력	마이데일리
클라라 "#cute" 청순한 미모로 뽐낸 단아美	인천일보
클라라, 명품 몸매 자랑…숨길 수 없는 대문자S 몸매	스포츠조선
"여신 미모"…클라라, 감탄 나오는 아름다움 [리포트:컷]	TV리포트
클라라, 청초함 가득 미모...'예쁨 한도 초과'	뉴스컬처
[하주의 공연읽기] 백건우와 슈만	울산매일신문
클라라, 철저한 자기관리…운동 중 돋보이는 완벽 S라인	헤럴드POP
[조영석의 음악이야기] 브람스를 좋아 하세요?	국제신문
클라라, 섹시 쏙 빼고 러블리+청순 비주얼 완성..미모의 새댁	헤럴드POP
클라라, 한껏 물오른 미모...'상큼+큐티'	뉴스컬처
엔비디아, 영국 내 가장 강력한 헬스케어 AI 연구용 슈퍼컴퓨터 구축	게임포커스
클라라, 세련된 미모로 덕분에 챌린지 동참..최진혁-정아 다음 주자로 지목	헤럴드POP
클라라 주미 강·손열음 듀오, 4년 만의 리사이틀 9월 개최	뉴시스
클라라, 다리만 꼬았을 뿐인데…섹시 포스 작렬	마이데일리
클라라, 눈만 보여도 이렇게 예뻐..오늘은 청순 분위기	헤럴드POP
클라라, 꽃도 기죽이는 핑크빛 여신..화려함 끝판왕 미모	헤럴드POP
세계 석권한 젊은 거장 클라라주미강&손열음 듀오 리사이틀 공연	시사매거진
클라라, 튜브톱 의상입고 치명美 발산…아질한 심쿵 눈맞춤	헤럴드POP
‘최고 7%’ 박은빈X김민재, ‘브람스를 좋아하세요?’ 첫방부터 터졌다	더리더
클라라 주미 강·손열음, 9월 5일 수원서 듀오 콘서트	연합뉴스
'방송 복귀' 클라라, 얼굴만한 커피잔 들고...럭셔리 일상 끝판왕	스포츠조선
클라라, 다리 찢기가 이정도는 되어야지…헉소리 절로	헤럴드POP
[N샷] 클라라, 청바지 입어도 돋보이는 완벽 S라인	뉴스1
클라라, 전지현 뺨치는 긴생머리 그녀..유부녀의 리즈 경신 [★SHOT!]	OSEN
클라라, 디자이너 이청청과 다정 투샷…마스크도 패션 [★해시태그]	엑스포츠뉴스
클라라, 섹시 대신 러블리…무한 팔색조 매력 [★해시태그]	엑스포츠뉴스
클라라 "happy mask" 세련美 가득 셀피 한 컷	인천일보
클라라, 새 헤어스타일로 미모 폭발..살짝 솟은 귀까지 매력적	헤럴드POP
클라라, 새 헤어스타일로 미모 폭발..살짝 솟은 귀까지 매력적	헤럴드POP
MC 한석준X클라라 ‘차이나피디아’ 26일 첫 방송	스포츠경향
[인터뷰]클라라 주미 강 "손열음은 귀가 좋은 연주자"	뉴시스
클라라, '덕분에 챌린지' 참여 "감사와 존경"…최진혁·정아 지목 [★해시태그...	엑스포츠뉴스
클라라, 거울 속 완벽 `데칼코마니 S라인 몸매`	매일경제
클라라 복귀, 한석준·이독실과 ‘차이나피디아’ MC확정…7월 26일 첫방송	매일경제
클라라, 청순 섹시의 정석..민소매 입고 뽐낸 볼륨 몸매	헤럴드POP
美 무더위 속 '경찰 남편' 순찰차에 갇힌 아내 사망	YTN언론사 선정
클라라, 파란 드레스 입고 여신美..청순 섹시 다 되는 경국지색	헤럴드POP
이상봉子 이청청과 친분 과시한 클라라…숨길 수 없는 ‘볼륨감’	세계일보
클라라, 청순↔섹시 오가는 반전 매력…변함없는 여신 미모 [★해시태그]	엑스포츠뉴스
클라라 주미 강·손열음 4년 만의 듀오 무대	서울경제
'비수기 없는 미모' 클라라, 야외카페서도 드러나는 각선미 [★SNS]	스포츠서울
"애플힙+완벽 S라인" 클라라, 다이어트 자극짤 탄생..살아있는 바비인형 [★S...	OSEN
클라라, 이토록 섹시한 다리 꼬기..샤론스톤 하나도 안 부러워	헤럴드POP
클라라, 몸매 드러나는 드레스 입고 섹시美 자랑 [똑똑SNS]	MK스포츠
'브람스를 좋아하세요?' 박은빈X김민재, 서로를 향한 이끌림…첫방부터 터졌다	한국경제
클라라 "#beautiful #flowers #happy #positivevibes" 여신 아우라 과시	인천일보
클라라, 샤론 스톤보다 우월한 섹시한 다리꼬기..트집잡기 불가	헤럴드POP
클라라가 두 명? 섹시함도 두 배!	머니S
클라라가 두 명? 섹시함도 두 배!	머니S
클라라, 짧은 치마 입고 뽐낸 8등신 비주얼…요염한 새댁의 자태	헤럴드POP
클라라, 사람이야 마네킹이야..감탄유발 美친 기럭지	헤럴드POP
클라라, 앉아만 있어도 섹시한 이유..몸매가 넘사벽	헤럴드POP
클라라, ‘차이나피디아’로 결혼 후 첫 국내 방송 복귀(공식)	뉴스엔
클라라 "WHAT'S YOUR FAVORITE COLOR?" 새댁의 외출 들여다보니?	인천일보
클라라 주미 강 손열음, 4년 만에 다시 무대오른다	노컷뉴스
클라라, 새빨간 의자에 앉아 고혹미 "올블랙 원피스 깜짝"	데일리한국
클라라, 레드 립으로 더한 '시크+치명' 매력	뉴스컬처
클라라, 올 퍼플룩도 찰떡소화…자기관리 끝판왕의 완벽 S라인	헤럴드POP
클라라, 청순 가득 '덕분에 챌린지'…"작은 보탬 될게요" [★SHOT!]	OSEN
"오늘은 보라색 무드" 클라라, 남다른 패션센스 [★SHOT!]	OSEN
클라라 복귀, 인문교양토크쇼 차이나피디아’MC 확정…지식 뽐낼 것	데일리한국
"시선을 어디에..." 클라라 근황, 초미니 각선미 '아슬' [리포트:컷]	TV리포트
클라라 ‘품절녀 입증한 반지’[포토엔HD	뉴스엔
클라라, 눈부신 꿀벅지 셀카..결혼 후에도 변함없이 관리 중인 미녀	헤럴드POP
클라라 "Beautiful weather today" 여신 아우라 과시 셀피 한 컷	인천일보
"이런 감성, 오랜만"…첫방 '브람스를 좋아하세요?', 웰메이드 드라마 탄생	SBS funE
클라라, 중국서 대박 난 근황 "나도 안 믿긴다"	머니S
‘클라라 주미강, 손열음 듀오 리사이틀’ 수원SK아트리움 공연	헤럴드경제
‘클라라 주미강, 손열음 듀오 리사이틀’ 수원SK아트리움 공연	헤럴드경제
4년만의 재회한 선후배…손열음·클라라 주미 강 무대 오른다	뉴스1
클라라 주미 강-손열음, 4년 만에 듀오 리사이틀	서울신문
클라라, 청록색 브릿지로 트렌드세터 합류 ‘요정 미모’ [SNS★컷]	뉴스엔
클라라 "#나홀로짐에" 자기 관리의 교과서 들여다보니?	인천일보
클라라, 꽃도 기죽이는 미모…동화 속 공주님 같은 일상 [★해시태그]	엑스포츠뉴스
클라라주미강&손열음 듀오 리사이틀	제주교통복지신문
클라라, 퀸(Queen) 표지촬영 현장① [퀸TV(Queen)]	Queen
클라라, 시크한 패션..다이아 반지 자랑	스타뉴스
클라라 ‘머리만 넘겨도 화보 컷’ [포토엔HD]	뉴스엔
[TV북마크] 첫방 ‘브람스를 좋아하세요?’ 박은빈♥김민재, 감성 로맨스…최...	스포츠동아
배우 클라라, 퀸(Queen) 표지·화보 촬영 현장②[퀸TV(Queen)]	Queen
손열음·클라라 주미 강, 듀오 콘서트	세계일보
클라라, 비수기 없는 여신 미모..자체발광 꽃비주얼	헤럴드POP
[클래식, 기억하다] 클라라에게 바치는 세레나데 widmung, 피아노의 시인 슈만...	문화뉴스
클라라, 허리가 활처럼 휠 수 있나? 엄청난 유연성[SNS★컷]	뉴스엔
클라라 방송 복귀, '차이나피디아' MC 확정..무려 인문 교양 토크쇼	enews24
클라라 "#혼자놀기" 뿌까 머리로 뽐낸 팬심 저격 아우라	인천일보
"35살→25살이 되는 마법"..클라라, 세월 피해간 '동안美 끝판왕' [★SHOT!]	OSEN
클라라 "#flexibility #healthylifestyle #workout" 팬심 강탈 아우라 과시	인천일보
클라라 "#flexibility #healthylifestyle #workout" 팬심 강탈 아우라 과시	인천일보
클라라, 독보적인 글래머 보디라인..미모+몸매 다 가진 여자	헤럴드POP
클라라 ‘꿀 떨어지는 새댁 미소♥’[포토엔HD]	뉴스엔
클라라, 시원하게 드러낸 각선미…넘사벽 비율	마이데일리
'방송 복귀' 클라라, 여유로운 티타임 '화려한 비주얼'	마이데일리
클라라, 티셔츠 한 장만 입어도 티나는 글래머 몸매 "감사합니다"	헤럴드POP
SC카운티 곧 식당 실내 영업 허용	미주한국일보
'브람스를 좋아하세요?' 작가 "왜 수많은 음악가 중 '브람스'냐고요?"	YTN
클라라, 햄버거 앞에서도 완벽 미모..이렇게 먹어도 살이 안쪄?	헤럴드POP
한석준·클라라·이독실, 인문교양토크쇼 ‘차이나피디아’ MC 확정	스포츠월드
클라라 주미 강-손열음, 9월5일 수원SK아트리움서 리사이틀	수원일보
클라라 "#sunshine #icevanillalatte" 팔색조 아우라로 뽐낸 일상의 여유	인천일보
클라라, 시선강탈하는 11자 각선미…고급진 아우라에 심쿵	헤럴드POP
"유부녀 맞아?"… 클라라, 섹시 블랙녀→ 청순 요정 '팔색조 변신'	머니S
클라라, 세련된 비주얼에 팔색조 매력..깜찍 애교+도도한 눈빛	헤럴드POP
클라라 주미 강·손열음 듀오 콘서트, 온라인으로 본다	헤럴드경제
‘브람스를 좋아하세요?’ 작가 “음대생 박은빈X피아니스트 김민재 싱크로율...	스포츠동아
박은빈X김민재 ‘브람스를 좋아하세요?’ 첫방부터 터졌다…6.2% 기록 [MK★T...	MK스포츠
제주서 클라라주미강-손열음 무관객 온라인 공연	내외뉴스통신
'브람스를 좋아하세요?' 시청자 과몰입 유발하는 '6각 관계' 비결은?	스포츠조선
클라라, 레깅스 입고 뽐낸 유연성…선 채로 다리 찢기 '성공' [★해시태그]	엑스포츠뉴스
클라라 "Have a great #weekend" 물오른 미모 과시 셀피 한 컷	인천일보
클라라 주미 강&손열음, 9월 수원SK아트리움서 호흡 맞춘다	경기신문
클라라가 2명?..데칼코마니 사진 투척..요염한 자세[★SHOT!]	OSEN
클라라 ‘앞치마 입는 모습 보니 새댁 ’[포토엔HD]	뉴스엔
'브람스를 좋아하세요?' 박은빈X김민재 둘러싼 6각관계, 흥미로운 이유	한국경제
클라라, 초록색 의상도 찰떡 소화..모델 못지 않은 우월 아우라	헤럴드POP
오픈뱅크 산타클라라점 코로나 뚫고 적극적 마케팅	미주한국일보
슈만의 젊음과 광기를 담다, 피아니스트 백건우 '슈만' 발매	문화뉴스
클라라, 청순부터 섹시+러블리까지..소녀 같은 미모[★SHOT!]	OSEN
클라라, 청순부터 섹시+러블리까지..소녀 같은 미모[★SHOT!]	OSEN
클라라, 다리찢기로 보여준 유연성 '오늘도 트렌디한 팔방미인'	스타뉴스
클라라, 힙한 패션 감각+8등신 자태에 '시선 강탈' [★해시태그]	엑스포츠뉴스
‘브람스’ 류보리 작가 “박은빈-김민재, 싱크로율 100%” (인터뷰)	스포츠동아
클라라, 군살제로 보디라인에 헉소리가 절로…모든 순간 눈부신 자태	헤럴드POP
클라라, 꽃보다 압도적인 `꿀벅지 S라인`	매일경제
클라라, 슬립 드레스 입은 화보 공개…'흑백 챌린지' 동참	머니투데이
박은빈X김민재 '브람스를 좋아하세요?' 감성드라마 탄생…최고 7%까지	엑스포츠뉴스
"빌어먹을 S코리아, 손정우 보내라" 미국민들 이유있는 분노	오마이뉴스언론사 선정
클라라, 모자+마스크도 못 가리는 미모…"큐트" [★해시태그]	엑스포츠뉴스
클라라, 모자+마스크도 못 가리는 미모…"큐트" [★해시태그]	엑스포츠뉴스
한예종 02학번 손열음·04학번 클라라 주미 강 '16년 호흡 맞춘 듀오콘서트' ...	아이뉴스24
클라라 주미 강·손열음, 4년 만에 듀오 리사이틀	헤럴드경제
클라라, 거울만 닦았을 뿐인데..반전 여신美로 '깜짝'	헤럴드POP
[정덕현의 엔터인사이드] ‘브람스를 좋아하세요?’…멜로가 현실을 품을 때	매일신문
클라라 "여러분의 파우치 필수템은 뭐에요?" 러블리 아우라 과시 셀피 한 컷	인천일보
클라라, 깜찍뽀짝 매력 가득..."엄청 큰 커피잔"	뉴스컬처
클라라, 새색시의 완벽한 얼룩말 패션 “alone” [M+★SNS]	MBN
[HI★뭐하세요?] 클라라, 감출 수 없는 ‘대문자 S라인’	한국일보
클라라 근황, '핫팬츠 입은 비현실적 9등신'	TV리포트
클라라, 결혼 하더니 더 예뻐졌네..반박불가 美친 비주얼+몸매	헤럴드POP
클라라, 결혼 후에도 치명적 섹시美..글래머+각선미 넘사벽 몸매	헤럴드POP
클라라, 고난도 동작도 거뜬…유연성 넘치는 군살제로 몸매 자랑	헤럴드POP
클라라, 빠져드는 눈빛+우월한 비주얼…점점 예뻐지네 [★해시태그]	엑스포츠뉴스
손열음·클라라 주미 강 리사이틀, 4일 유튜브에서 무관중 생중계로	서울신문
클라라, 근황에 갑자기 무대에서 `휘청` 알고보니…	내외경제tv
수원문화재단, ‘클라라 주미강, 손열음 듀오 리사이틀’ 공연	NSP통신
'브람스를 좋아하세요?' 감성 통했다…순간 최고 시청률 7% [어젯밤TV]	마이데일리
클라라, '황금골반' 미니 원피스 자태	머니S
배우 클라라, 아찔한 각선미...'아름다운 빵이에요~'[★SNS]	스포츠서울
배우 클라라, 아찔한 각선미...'아름다운 빵이에요~'[★SNS]	스포츠서울
박은빈-김민재, 서로 다른 ‘브람스’ 의미 드러났다 [어제TV]	뉴스엔
클라라, 3년만에 국내 방송 복귀…'차이나피디아' MC 발탁[공식입장]	스포티비뉴스
"꽃 중에 꽃"..클라라, 막 찍어도 '화보 일상' [★SHOT!]	OSEN
 클라라, 엘프인 줄..제니처럼 초록색 브릿지 도전 ‘예쁨 폭발’[★SHOT!]	OSEN
클라라 `풍부한 성량과 음색으로 미스그랜드코리아 축하공연` [MK포토]	MK스포츠
클라라, 야외 카페서 쭉뻗은 각선미 자랑 '한눈에 봐도 연예인' [★SHOT!]	OSEN
'차이나피디아' 오늘(26일) 첫 방송…한석준·클라라·이독실, MC 찰떡호흡	엑스포츠뉴스
클라라 ‘앞치마 입고 인사하는 모습 보니 새댁 ’[포토엔HD]	뉴스엔
첫방 '브람스를 좋아하세요', 최고 7%..취향저격 웰메이드 탄생 [종합]	스타뉴스
'브람스' 작가 "음대생 박은빈X피아니스트 김민재, 싱크로율100%"	이데일리
클라라, 운동하며 '섹시 윙크+S라인 몸매' 과시 "나홀로"	스포츠조선
“믿기지 않아”…클라라, 中서 3600만뷰 대박난 콘텐츠 무엇?	이데일리
클라라, 국내 활동 재개…‘차이나피디아’ 오늘 첫 방송	스포츠동아
클라라, 빵 먹는 모습도 화보…환상적인 뷰 즐기는 '8등신 바비인형' [★해시...	엑스포츠뉴스
클라라, 오프숄더로 시원하게 드러난 어깨라인...'비율 천재'	뉴스컬처
클라라, 화이트 탱크톱으로 뽐낸 몸매 ‘볼륨감 최고’ [SNS★컷]	뉴스엔
클라라, '심쿵' 유발하는 미모...'일상이 화보'	뉴스컬처
[리뷰] 안방에서 만난 인기 듀오…손열음·클라라 주미 강의 강렬한 ‘입맞춤...	서울신문
클라라, 명품백 보다 빛나는 5:5 가르마..디저트도 럭셔리 [★SHOT!]	OSEN
클라라, 명품백 보다 빛나는 5:5 가르마..디저트도 럭셔리 [★SHOT!]	OSEN
클라라, 청바지만 입어도 감탄 자아내는 '늘씬' 비율	뉴스컬처
클라라, '늘씬' 비율에 시선 고정...환한 미소는 덤	뉴스컬처
‘브람스’ 박은빈X김민재, 삼각관계 속 순정이 이렇게 절절하단 건[TV와치]	뉴스엔
[포토] 김민재-박은빈 '브람스-클라라-슈만의 삼각관계'	일간스포츠
클라라, 머리부터 발끝까지 보라색…멀리서 봐도 연예인 [★해시태그]	엑스포츠뉴스
[팝업★]클라라, 군살 하나 없는 완벽 볼륨 몸매..결혼 후에도 여전히 '핫'(종...	헤럴드POP
클라라, 운동으로 다져진 완벽 S라인 몸매…결혼 후 더 '핫피플'	여성조선
‘브람스를 좋아하세요?’ 박은빈X김민재 둘러싼 6각관계, 시청자 과몰입 유발	더리더
박진경 ‘브람스·리스트·클라라·슈만의 낭만 피아노’ 들려준다	아이뉴스24
‘브람스를 좋아하세요?’ 박은빈X김민재 둘러싼 6각관계, 시청자 과몰입 유발	더리더
박진경 ‘브람스·리스트·클라라·슈만의 낭만 피아노’ 들려준다	아이뉴스24
클라라 챌린지 "의료진 헌신에 감사드린다"	머니S
클라라, 얼룩말 옷도 소화하는 미녀..몸매가 예술이야	헤럴드POP
손열음·클라라 주미 강 리사이틀, 예술의전당→롯데콘서트홀로 변경	서울신문
'브람스를 좋아하세요' 작가, "수많은 음악가 중 왜 브람스냐면…"	MBC연예
세 여자의 유쾌한 모먼트 '페뷸러스' 11월 5일 개봉확정	뉴스포인트
[리뷰] 클라라가 된 손열음, 슈만의 사랑을 들려주다	한국일보
산타클라라시와 49ers 충돌	미주한국일보
클라라, ♥︎남편과 주말 맛집 데이트? 행복 가득 미소[★SHOT!]	OSEN
클라라, ♥︎남편과 주말 맛집 데이트? 행복 가득 미소[★SHOT!]	OSEN
‘브람스’ 박은빈X김민재 둘러싼 6각관계, 시청자 과몰입 유발	매일경제
클라라, 긴생머리 휘날리며..살아 있는 바비인형 몸매[★SHOT!]	OSEN
'브람스를 좋아하세요?' 박은빈-김민재, 서로를 향한 이끌림..첫방부터 7%	enews24
'여신 미모' 클라라 "Have a great #weekend" 물오른 미모 과시 셀피 한 컷	기호일보
클라라, 화보 같은 일상 '고혹적인 미모'	머니S
클라라, 블리치 헤어+올 퍼플룩 찰떡..볼륨감까지 갖춘 패셔니스타 [★SHOT!]	OSEN
구미문화예술회관, 클라라 주미 강 & 손열음 듀오 리사이틀 기획공연	경북도민일보
[인터뷰] 클라라의 요즘...미모와 건강 관리부터 자녀계획까지 [퀸TV(Queen)]	Queen
클라라 "#denim" 결혼 후 더욱 물오른 미모 들여다보니?	인천일보
클라라 "#denim" 결혼 후 더욱 물오른 미모 들여다보니?	인천일보
'클라라의 전쟁'을 읽고	제민일보
클라라, 일상에서도 돋보이는 인형미모+명품몸매 끝판왕 [리포트:컷]	TV리포트
'브람스를~' 작가 "음대생 박은빈X피아니스트 김민재, 싱크로율 100%"	스포츠서울
클라라 "alone" 여신 미모로 더한 황금 비율 기럭지	인천일보
마스크 쓴 클라라, 건강한 몸매…'운동 자극 사진'	TV리포트
"잘 어울리는 커플"…클라라, 남편과 셀카 공개?	머니S
클라라, 파격 올퍼플룩도 완벽 소화…감탄 나오는 콜라병 몸매	마이데일리
'브람스를 좋아하세요?' 박은빈X김민재 둘러싼 6각 관계..숨막히는 텐션	헤럴드POP
클라라→최진혁x정아, 덕분에 챌린지 지목 “생활 속 작은 실천할 것”	뉴스엔
'브람스를 좋아하세요?' 박은빈X김민재 둘러싼 6각 관계..숨막히는 텐션	헤럴드POP
클라라→최진혁x정아, 덕분에 챌린지 지목 “생활 속 작은 실천할 것”	뉴스엔
클라라, 핫팬츠 입고 과감 다리 노출..비현실적 다리길이에 깜짝 ‘10등신?’...	OSEN
[영화] 페뷸러스	아트인사이트
클라라 주미 강·손열음 만난다	국방일보
클라라, ♥︎남편 어디 두고 만찢남에게 백허그→머리 쓰담쓰담 ‘미소 폭발’...	OSEN
노벨문학상 수상 작가 가즈오 이시구로 내년 봄 신작 장편 '클라라와 태양' 출...	파이낸셜뉴스
[더오래]슈만에 교향곡 영감 준 라인강	중앙일보
‘브람스’ 작가 “음대생 박은빈X피아니스트 김민재, 싱크로율100%”	매일경제
클라라, ♥사무엘 황 불안케하는 꽃미모…168cm 장신의 시원한 '기럭지'	스포티비뉴스
클라라, ♥사무엘 황 불안케하는 꽃미모…168cm 장신의 시원한 '기럭지'	스포티비뉴스
‘브람스’ 박은빈X김민재 둘러싼 6각관계, 답답하지 않은 이유	뉴스엔
클라라 근황, 군살 없는 몸매 비결은 다리 찢기? [리포트:컷]	TV리포트
'브람스를 좋아하세요?' 작가 "음대생 박은빈X피아니스트 김민재, 싱크로율10...	스포츠조선
클라라 고혹적인 분위기 '뿜뿜'…'#womensupportingwomen' 캠페인 동참	조이뉴스24
클라라, 블랙 미니 원피스 입고 아찔한 '각선미' 과시	MBN
클라라, 눈만 보여도 예쁨 폭발..시크美 철철	헤럴드POP
산타클라라 테니스클럽‘창립 38주년 기념대회’	미주한국일보
첫방 '브람스', 최고 시청률 7%…월화극 1위 올랐다	조이뉴스24
시의원직에 3번째 도전장	미주한국일보
시의원직에 3번째 도전장	미주한국일보
클라라, 11자 복근+개미허리➝결혼 후에도 명불허전 명품 몸매 자신감[종합]	OSEN
[EMS 주최 ‘발의안 T 찬성 촉구 기자 간담회’] “녹지 보존 발의안 T 찬성해...	미주한국일보
다시 만난 클래식계 절친	강원일보
[안용모의 배낭 메고 중미를 가다] 쿠바 산타 클라라(Santa Clara)	영남일보
'브람스' 작가 "음대생 박은빈·피아니스트 김민재, 싱크로율 100%" (인터뷰)	엑스포츠뉴스
클라라, 꽃도 기죽이는 이기적인 비주얼 [★해시태그]	엑스포츠뉴스
클라라 복귀... 중국 중화TV '차이나피디아' MC로 출연	MBN
피아니스트 백건우, 슈만의 젊음과 광기를 담은 신보 '슈만' 발매	매일일보
클라라, 꾸준한 관리로 완성한 탄탄 애플힙 '치명적 몸매'	마이데일리
클라라 "의료진, 방역관계자, 자원봉사자 여러분 다시한번 감사드립니다" #덕...	인천일보
[지자체의 SR-문화] 수원문화재단, '클라라 주미강, 손열음 듀오 리사이틀' 공...	SR타임스
클라라, 탱크톱으로 뽐낸 섹시함 "촬영중"	한강타임즈
선거자금 기부로 총기 휴대 허용	미주한국일보
수원SK아트리움서 손열음 피아니스트, 클라라주미 강 바이올리니스트 듀오 리...	중부일보
클라라, '빵 먹방'도 섹시하게..각선미 자랑	스타뉴스
‘중국 배우’ 클라라, 중화TV ‘차이나피디아’로 복귀	머니S
손열음·클라라 주미 강 4년만에 선보이는 듀오 무대	아시아경제
'브람스를 좋아하세요' 박은빈X김민재, 첫방부터 터졌다···'최고 시청률 7...	서울경제
발렌시아 레전드 "이강인, 더 많은 출전 기회 잡아야"	골닷컴
박은빈X김민재 둘러싼 6각관계인데…왜 안답답하지?	아이뉴스24
수원SK아트리움, ‘클라라 주미 강, 손열음 듀오 리사이틀’ 9월의 아름다운 ...	한스경제
클라라 주미 강 & 손열음 듀오 리사이틀, 다음달 8일 구미서 열려	영남일보
‘브람스를 좋아하세요?’ 박은빈×김민재 둘러싼 6각관계, 답답하지 않고 흥...	스포츠경향
클라라주미강&손열음 듀오 리사이틀	제주매일
현장에서 듣는 음악의 기쁨!…피아니스트 손열음 리사이틀	연합뉴스
차량 거주자용 주차 공간 마련	미주한국일보
[D:인디그라운드⑰] 클라라C “벌써 10년, 유튜브 덕분에 ‘뮤지션’됐죠”	데일리안
눈부신 클래식 듀오 클라라 주미 강과 손열음 리사이틀, 다음달 5일 수원 여름...	경기일보
[이성주의 건강편지]사랑은 모든 것을 떠나 아름다운가?	코메디닷컴언론사 선정
[이성주의 건강편지]사랑은 모든 것을 떠나 아름다운가?	코메디닷컴언론사 선정
'브람스를 좋아하세요?' 작가 "박은빈X김민재, 음대생이라 해도 될 연주 감동...	헤럴드POP
‘차이나피디아’ 중국 ‘허베이성’의 모든 것을 알아본다	한국경제
산타클라라카운티 경제재개 2단계로 격하	미주한국일보
클라라 주미 강& 손열음 듀오, 4년 만에 만난다	위드인뉴스
‘철파엠’ 박은빈 ‘브람스’ 위해 직접 바이올린 연주까지 #남궁민 #딕션(종...	뉴스엔
클라라, 막 찍어도 숨멎 자태 ‘힙하다 힙해’ [SNS★컷]	뉴스엔
새댁 클라라 ‘지금봐도 꽃 미모’[포토엔HD	뉴스엔
클라라, 청순→발랄→치명…남심 저격 '매력 부자' [★해시태그]	엑스포츠뉴스
클라라, 초미니 드레스로 환상적 비율 자랑…아찔한 자태 [★해시태그]	엑스포츠뉴스
클라라 복귀… 근황미모	천지일보
클라라, 청순+섹시美의 정석…글래머스한 몸매 자랑 [M+★SNS]	MBN
'한밤' 클라라 "숏폼 콘텐츠 3600만 뷰, 안 믿겼다"	티브이데일리
클라라, 시크한 매력 담은 화보 컷 공개	머니S
클라라, 美친 미모+글래머 몸매..반짝이는 결혼반지도 시선강탈	헤럴드POP
[취재파일] 방콕에 지친 당신을 위해(52) - 공연 영상으로 즐기는 화제의 곡 ...	SBS
새댁 클라라 ‘품절녀 입증한 반지’[포토엔HD	뉴스엔
[공연소식] 세종문화회관·예술의전당·롯데콘서트홀 9월 공연 소식... 클라라...	문화뉴스
산타클라라 카운티 코스트코 매장4곳서 직원31명 코로나 감염	라디오코리아
‘브람스’ 류보리 작가 “음대생 박은빈X피아니스트 김민재, 싱크로율100%”...	뉴스엔
'브람스를 좋아하세요?' 류보리 작가 "박은빈 바이올린 연주 연기, 음대생같았...	마이데일리
클라라, 모든 일상이 화보…흠 잡을 데 없는 완벽 비주얼 [★해시태그]	엑스포츠뉴스
[중화TV] ‘차이나피디아’ 오는 7월 26일(일) 첫 방송! MC 한석준-클라라-이...	인민망
구미문화예술회관 '클라라 주미 강&손열음 듀오 리사이틀'	쿠키뉴스
클라라, 앉아만 있어도 화보 같네 ‘군살 無 S라인’[SNS★컷]	뉴스엔
대한민국 클래식'젊은 거장'들의 만남	경북매일신문
중화TV, 7월 26일 '차이나피디아' 첫 방송	매일일보
새댁 클라라 ‘결혼 후 첫 국내 행사 나들이’[포토엔HD	뉴스엔
클라라, 연보라 찰떡소화 패셔니스타…운동으로 다져진 군살제로 몸매	헤럴드POP
'한밤' 정다빈 "한동안 일상에서 욕을 달고 살았다".. 헨리&클라라의 '숏폼 콘...	엔터미디어
바이올리니스트 클라라 주미 강, 손열음과 함께 제주 찍고 대구까지	일요시사
클라라, '덕분에 챌린지' 동참 "의료진 등에 진심어린 감사"…다음 주자 최진...	미디어펜
제주 안방에서 듣는 '젊은 거장'의 선율	한라일보
클라라가 두 명? 초밀착 운동복에 드러난 '완벽 몸매'	마이데일리
'브람스', 박은빈·김민재의 순한 멜로에 은근히 빠져드는 까닭	엔터미디어
클라라, 복귀 확정…중화TV 인문교양토크쇼 '차이나피디아' MC 됐다	미디어펜
4년 만에 다시 손잡은 클래식계 ‘눈부신 듀오’	머니투데이
산타클라라카운티 코로나 검사소 6곳 추가	미주한국일보
'브람스를 좋아하세요?'…클래식 선율로 피어나는 청춘의 사랑과 꿈 [김희경의...	한국경제
경북 구미서 온택트 공연 펼친 클라라 주미 강 & 손열음 듀오 "코로나 극복 후...	영남일보
클래식계 절친, 수원서 만난다	인천일보
클라라, 운동 중 섹시 윙크+미소..S라인 몸매 ‘감탄’ “나홀로”[★SHOT!]	OSEN
'브람스를 좋아하세요?' 박은빈·김민재, 친구의 애인 사랑했다…이유진·박지...	마이데일리
'차이나피디아' 7월 26일 첫 방송 확정	한스경제
베이지역 코로나확진자 5만5천명 넘어	미주중앙일보
클라라, 걸어다니는 마네킹…CG 같은 비현실적 몸매+비율 '실화?' [★해시태그...	엑스포츠뉴스
'노벨문학상' 작가 가즈오 이시구로, 신작 소설 내년 봄 출간	뉴시스
클라라, 잘록 개미허리+애플힙..8등신 비너스 몸매[★SHOT!]	OSEN
음식배달 앱 수수료 15% 이하로 제한	미주한국일보
클라라, 보라색 밀착 원피스로 뽐낸 몸매 ‘볼륨감↑’ [SNS★컷]	뉴스엔
[시그널] 국내 첫 해외 데이터센터 기반 리츠 나온다	서울경제
[유(윤종)튜브]슈만 협주곡에 어른거리는 유령의 그림자	동아일보언론사 선정
"열음 언니와 호흡 10년…혼자 무대 서는 것처럼 편해"	매일경제
수원문화재단, 클라라 주미강·손열음 '듀오 리사이틀' 선봬	뉴스웍스
‘브람스를 좋아하세요?’ 류보리 작가 "박은빈X김민재, 싱크로율100%" [일문...	TV리포트
SC카운티 식당영업 ‘진퇴양난	미주한국일보
"몸매 美쳤다"..클라라, 초미니 원피스+블랙 힐로 완성한 '아찔' 뒤태 [★SHO...	OSEN
클라라, 결혼 후 점점 예뻐져..감출 수 없는 아찔한 볼륨감[★SHOT!]	OSEN
[리뷰] '명불허전 듀오' 클라라 주미 강 & 손열음의 라이브 콘서트, 내일의 희...	위드인뉴스
서니베일 초등학교 첫 대면 수업	미주한국일보
SC카운티 코로나 검사소 오픈	미주한국일보
대한민국 클식을 대표하는 젊은 거장 제주팬들과 만난다	제주일보
엔비디아, 클라라 헬스 케어 확장..."코로나19 대응"	AI타임스
바이올리니스트 클라라 주미 강·피아니스트 손열음 '환상의 듀오' 행복한 선...	열린뉴스통신
박은빈X김민재 ‘브람스를 좋아하세요?’, 첫회 순간 최고 시청률 7% ‘눈길’	브레이크뉴스
그녀의 손가락 위로 흐르는 건반의 위로	서울신문
클라라 복귀작은 중화TV '차이나피디아'	티브이데일리
클라라, 롱다리+직각 어깨..초록 투피스 완벽 소화하는 美친 몸매[★SHOT!]	OSEN
보행자 신호 모두 터치리스로	미주한국일보
[피플&피플]다시 뭉친 세계적인 아티스트 선후배	강원일보
[피플&피플]다시 뭉친 세계적인 아티스트 선후배	강원일보
“코로나19 통계 믿을 수 없다”	미주한국일보
[검은사막] 음악 앨범 악기 5종 추가! 신규 칭호, 버프, 지식 획득하자	인벤
박은빈x김민재 재발견, '브람스를 좋아하세요'가 남긴 것	한국경제
클라라, 완벽한 몸매 뽐내며 2m 거리두기…'♥사무엘 황'은 복 터졌네	스포티비뉴스
격정적이고 노골적인 러브레터…손열음식 슈만이 나왔다	중앙일보
슈만의 사랑과 드뷔시의 위로 "이 힘든 시간도 곧 지나갈 거야"	조선일보
제24회 부산국제영화제 관객상 수상 '페뷸러스' 10월 개봉	뉴스포인트
알라메다카운티 미용실·샤핑몰 오픈	미주한국일보
[리뷰] 손열음 ‘사랑과 환상’의 달빛 콘서트… “우린 강해졌고, 이겨낼 거...	서울신문
[TV북마크] ‘브람스를 좋아하세요?’ 박은빈♥김민재, 꿈+사랑 성장→깊은 울...	스포츠동아
[리뷰] 손열음 ‘사랑과 환상’의 달빛 콘서트… “우린 강해졌고, 이겨낼 거...	서울신문
[엔비디아 특약] 병실 안 가도 확인, '디지털 창문'의 비밀	더스쿠프
카운티별 경제재개 상황	미주한국일보
코로나19, 교육 받을 기회 불평등 초래	미주한국일보
피아니스트 백건우, 17일 신보 '슈만' 발매‥전국투어 돌입	K STAR
클라라, 사업가와 결혼 후 완벽 관리 몸매 '마스크 쓰고 운동'	일요신문
클라라, 여전한 미모로 '코로나19 덕분에 챌린지' 동참.."진심 어린 감사와 존...	뉴스인사이드
클라라 복귀, 프로야구 시구 사상 역대 최강 비주얼 의상!	폴리뉴스
[세상을 보며] 알프스 소녀 하이디와 하동- 허충호(사천남해하동본부장·국장...	경남신문
클라라, 여전히 아름다운 미모..'차이나피디아' MC로 연예계 복귀	뉴스인사이드
[일문일답]'브람스' 박지현 "미성숙한 정경이 보며 안쓰러웠지만…"	노컷뉴스
성자들의 마을, 아시시 가는 길	매일노동뉴스
KBS교향악단 코로나19 후 두번째 관객초청 공연…소프라노 임선혜 협연	아시아경제
클라라 "숏폼 콘텐츠로 중국서 대박, 연예인 중 4위"(한밤) [TV캡처]	스포츠투데이
SC카운티 무료 독감 예방 주사	미주한국일보
SC 카운티 주민에 무료 코로나19 검사	미주한국일보
베이지역 임금 ‘전국 최고’	미주한국일보
박은빈·김민재 재발견…'브람스를 좋아하세요?'가 남긴 것	이데일리
박은빈 "아직 자기를 탐구하고 싶은 열망 있다면 청춘 아닐까요"	노컷뉴스
종영 '브람스를 좋아하세요?' 박은빈X김민재, 클래식 로맨스 물결 '최고 7.4%...	스포츠조선
'슈만' 연주하는 백건우 "그의 인생이 이제 좀 이해돼"	연합뉴스
'새댁의 반전' 클라라 "#stayhome #playwith (카메라)" 고혹적 아우라 과시 '...	기호일보
밀피타스 주민들 홈키 프로젝트 반대	미주한국일보
'8등신 몸매' 클라라, 화보 같은 일상	머니S
SC카운티 퇴거 금지 연장·벌금 부과	미주한국일보
베이 전지역서 일부 소매업소 영업재개	미주한국일보
한인상가 밀집지역 엘카미노 리얼서 강도 살인사건	미주한국일보
해커스어학원, 토익·토스·오픽 첫 시험에 완성하는 학습 전략 공개	아이티비즈
마린 카운티 양성반응 12.9%	미주한국일보
해커스어학원, 토익·토스·오픽 첫 시험에 완성하는 학습 전략 공개	아이티비즈
마린 카운티 양성반응 12.9%	미주한국일보
종영 ‘브람스를 좋아하세요?’ 박은빈×김민재의 클래식 로맨스 [간밤TV]	스포츠경향
【코로나19 K극복 ‘히든기업’을 찾아서 ⑬】 ㈜동양에스엔티 강창환 대표	시사뉴스
클라라, 비현실적인 9등신 몸매… "이 기럭지 실화? "	머니S
코로나19 사태로 정신질환자 양산	미주한국일보
클라라, 비현실적 비율로 뽐낸 몸매 ‘굴곡진 볼륨감’ [SNS★컷]	뉴스엔
영화같은 이생 마지막은 행복이란 종착역 나경찬 치과의	미주한국일보
프란치스코, 사라센군 진영에 들어가 술탄을 만나다	가톨릭평화방송·평화신문
북가주 4만여가구 ‘전력 복구’	미주한국일보
클라라, 비현실적 비율로 뽐낸 몸매 ‘굴곡진 볼륨감’ [SNS★컷]	뉴스엔
영화같은 이생 마지막은 행복이란 종착역 나경찬 치과의	미주한국일보
프란치스코, 사라센군 진영에 들어가 술탄을 만나다	가톨릭평화방송·평화신문
시청률도 유종의 미 ‘브람스를 좋아하세요?’가 남긴 것	뉴스엔
북가주 4만여가구 ‘전력 복구’	미주한국일보
[최지연의TV파보기] '브람스'vs'청춘기록', 월화극으로 맞대결하는 청춘 드라...	한스경제
퍼스널 케어·헬스장 실내 영업	미주한국일보
“누구도 그리스도를 따르는 것에 관면을 줄 수 없다”	가톨릭평화방송·평화신문
지상에서 본 천국, 이탈리아 아시시	여성조선
코로나 재확산‘봉쇄령’ 다시 발령	미주한국일보
코로나 재확산‘봉쇄령’ 다시 발령	미주한국일보
'브람스' 박은빈X김민재, 꿈과 사랑의 성장..앙상블甲 클래식 로맨스	enews24
인노첸시오 3세 교황, 1209년 작은 형제들 회칙 인준	가톨릭평화방송·평화신문
셀러비코리아, 프로골퍼 이지훈 메인스폰서십 체결	머니투데이
엔비디아, 헬스케어 플랫폼 ‘클라라’ 코로나19 지원 위해 대대적 업데이트	헬로티
SC 카운티 코로나19 검사 비율 미흡	미주한국일보
베이지역 카운티별 경제 재개 상황	미주한국일보
광기의 카니발…김혜수 배우도 추천한 그 영화 '더 헌트'	그라피
'브람스를 좋아하세요?'로 한 뼘 더 성장한 배우 김민재	넥스트데일리
CC카운티 봉쇄령 2단계 확장 돌입	미주한국일보
광기의 카니발…김혜수 배우도 추천한 그 영화 '더 헌트'	그라피
'브람스를 좋아하세요?'로 한 뼘 더 성장한 배우 김민재	넥스트데일리
CC카운티 봉쇄령 2단계 확장 돌입	미주한국일보
SC 초교 대면 수업 재개 승인	미주한국일보
SV경제, 코로나19 영향 덜 받아	미주한국일보
'브람스를 좋아하세요?' 감성과 위로 선물, 아름다운 마지막 장식	톱데일리
시민전쟁 포로가 된 프란치스코, 기사를 꿈꾸다	가톨릭평화방송·평화신문
클래식 선율 타고 성장한 청춘…'브람스를…' 6.0％ 종영	연합뉴스
의도한 건 아닌데…美대도시 월세 20~30% 빠진 이유	머니투데이
美 캘리포니아 교회들, “예배 금지는 위법” 주정부 소송	크리스천투데이
‘브람스’ 김민재♥박은빈 키스, 행복 찾고 사랑 이루며 ‘해피엔딩’ [어제...	뉴스엔
네오위즈 브라운더스트, 신규 조력자 4인 업데이트	시사오늘
숲속 동물의 은인들…야생동물구조센터의 72시간	조이뉴스24
베이지역 신규 확진자 40%‘껑충	미주한국일보
[포토]클라라, '단아한 자태'	아시아투데이
[포토]클라라, '눈부신 손인사'	아시아투데이
개방 후 가주 코로나 40% 증가	미주한국일보
SF 민주평통, 산타클라라 병원·양로원에 마스크 전해	월드코리안신문
[안종도의 음악기행 43] 로베르트 슈만 ‘영혼 변주곡’ | 천사가 내려와 들려...	이코노미조선
[포토]클라라, '한복입은것 처럼'	아시아투데이
[포토]클라라, '한복입은것 처럼'	아시아투데이
‘브람스를 좋아하세요?’ 박은빈♥︎김민재, 이별 아픔 겪고 견고해진 사랑 ...	OSEN
“그분을 응시하고 깊이 생각하고 관상하십시오”	가톨릭평화방송·평화신문
확진자 급증으로 경제 재개 지표 역주행	미주한국일보
바이러스 감염 우려 증폭	미주한국일보
클라라X헨리, ‘숏폼 콘텐츠’ 촬영 비하인드 공개	비즈엔터
성 프란치스코, 빛이신 하느님을 세상에 드러내신 분	가톨릭평화방송·평화신문
실리콘 밸리 차고마다 환하게 불 켜진 이유	이코노믹리뷰
[인터뷰③] '브람스' 김민재 "박은빈과 ♥라인..'준FOX' 아니라 100% 진심"	스포츠조선
'새댁의 일상' 클라라 "Happy Sunday~ What are you doing today?" 들여다보니	기호일보
실리콘 밸리 차고마다 환하게 불 켜진 이유	이코노믹리뷰
[인터뷰③] '브람스' 김민재 "박은빈과 ♥라인..'준FOX' 아니라 100% 진심"	스포츠조선
'새댁의 일상' 클라라 "Happy Sunday~ What are you doing today?" 들여다보니	기호일보
가주 일일 사망자 역대 최고	미주한국일보
'브람스' 박은빈, 바이올린 포기→김민재와 사랑 확인…"상처 받더라도 다시 ...	스포츠한국
퇴근길 한인간호사 교통사고 사망	미주한국일보
<이 남자의 클래식>어린이의 마음으로 작곡… 천진난만한 풍경을 연주하다	문화일보
'브람스를 좋아하세요?'박은빈·김민재, 음악 통해 재결합 '해피엔딩' 종영[S...	스포츠서울
클라라, 결혼 이후 첫 MC '차이나피디아'…한석준X김독실 호흡(공식)	싱글리스트
'51년 역사' 삼정KPMG, 경험과 전문성으로 성장세 지속	팍스경제TV
[문화단신] 유은혜, 여숙현, 하지연 3인전	가톨릭신문
브라운더스트, 신규 조력자 4인 업데이트	청년일보
'브람스를 좋아하세요?' 뜨거웠던 스물아홉 여운…클래식 로맨스 물결에 ‘최...	스포츠서울
수원문화재단, '클라라 주미강· 손열음 듀오 리사이틀' 공연	기호일보
[문화가산책] 신록과 갈망이 낳은 작곡세계	대전일보
'페뷸러스' 사랑스러운 여성 영화의 등장에 #기대된다 #보고싶다 반응 폭발!	뉴스포인트
페이스북, 뉴스 트래픽 조절하고 있었다	머니투데이
VTA 사우스 베이 연장 노선 6월 13일부터 운행 개시	미주한국일보
클라라, '숏폼 콘텐츠'로 中서 대박…'차이나피디아'로 방송 예고	톱스타뉴스
오리지널 메디케어 A, B 어떻게 신청하나요? [ASK미국 메디케어/보험- 클라라...	미주중앙일보
오리지널 메디케어 A, B 어떻게 신청하나요? [ASK미국 메디케어/보험- 클라라...	미주중앙일보
경제 재폐쇄...단속 규정은 모호	미주한국일보
브라질 계속되는 경찰폭력, 빈민가에서 항의 시위 이어져	울산저널
[주말사건사고] 알라메다 총격 청소년 3명 체포	미주한국일보
종영 ‘브람스’ 김민재♥박은빈 재결합, 커플링 키스 “사랑해요” (종합)	뉴스엔
남성이 여성보다 코로나 19 감염률 높아	미주한국일보
클라라 주미강X손열음, 4년만의 황금호흡...무관중 라이브 스트리밍	싱글리스트
해커스어학원, 하반기 채용 대비 ‘토익·토스·오픽 학습법’ 공개	뉴스케이프
마린카운티 식당 실내영업 중단	미주한국일보
'다큐3일' 개소 10주년 맞은 충남야생동물구조센터, 여전히 열악한 환경	일요신문
'다큐3일' 개소 10주년 맞은 충남야생동물구조센터, 여전히 열악한 환경	일요신문
강남∙종로 해커스어학원, 하반기 채용 대비 '토스∙오픽 고득점 전략' 공개	한국강사신문
'브람스를 좋아하세요?' 박은빈X김민재 '깊은 울림' 결말! 시청률 '최고 7.4%...	엔터미디어
클라라, 3년만에 국내 방송 '복귀'	아시아뉴스통신
코로나와 싸우는 컴퓨팅 파워...AI, 빅데이터, 슈퍼컴	AI타임스
“외출 자제하고 집에 있어라”	미주한국일보
SC카운티, 주정부 감시대상 포함	미주한국일보
'브람스를 좋아하세요' 류보리 작가는 누구?…원작 및 책 내용 어땠나	톱스타뉴스
코로나19 검사 여전히 장애물 많아	미주한국일보
가주 일일 사망자수 3달만에 최저	미주한국일보
조용한 열광 ‘브람스를 …’ 그 뒤엔 음대 출신 작가	중앙일보
《김두일 시론》 박원순의 마지막 선택	굿모닝충청
'브람스' 박은빈 "연기 재능 있나 고민하기도…크레센도 같은 삶 되길" [인터...	OSEN
'서울 페스티벌' 결국 무산…LA필 내년 봄 공연 취소	미주중앙일보
[Who Is ?] 윤석헌 금융감독원 원장	비즈니스포스트
'다큐멘터리 3일' 김규리 내레이션, 충남야생동물구조센터 72시간 '야생동물 ...	엔터미디어
'브람스를 좋아하세요' 육각 관계?…슈만x브람스x클라라 실제 원작 이야기는?	톱스타뉴스
프로골퍼 이지훈, 셀러비 소속 된다	팍스넷뉴스
대전시립연정국악원, '2020 바로크음악제' 18일까지 개최	대전일보
클라라가 전하는 '허베이성(하북성)'의 모든것 '차이나피디아'	비즈엔터
[시네마 클래식] 발레소년의 꿈을 향한 몸짓, '예스, 발레!' 음악	위드인뉴스
'브람스' 박은빈, ♥김민재 해피엔딩...바이올린 꿈 중단 "사랑하며 걸어나갈...	싱글리스트
셀러비, 프로골퍼 이지훈과 메인스폰서쉽 체결	아이뉴스24
[SK하이닉스 빅딜] 인텔, 메모리 전투서 철수하다	이코노믹리뷰
감성멜로의 귀환...'브람스를 좋아하세요?', 5.3% 출발	YTN
‘브람스’ 전연인 김성철-박지현 재회 “안녕” 열린결말 [결정적장면]	뉴스엔
[전문가 포커스] 세계적 경쟁력 갖춘 한국인의 문화유전자	투데이코리아
코로나19發 재택근무에 직원 이사행렬…美실리콘밸리 월세 '뚝'	아시아경제
바이올린·경영학 복수전공 ‘브람스를…’ 류보리 작가, 클래식 찐팬 사로잡...	중앙일보
클라라 복귀 '중국 MC'로?	아시아뉴스통신
클라라 복귀 '중국 MC'로?	아시아뉴스통신
코로나 전선 최일선 한인간호사 교통 참사	미주한국일보
[2020 교향악축제 리뷰] 깊은 심연에서 찬란한 빛까지, 교향악축제의 막을 연...	위드인뉴스
박은빈, 김민재 무대에 눈물…'브람스를 좋아하세요?' 5.3% 출발	뉴시스
'브람스를 좋아하세요' 드디어 첫방, 본격 음악 드라마 출격	한국경제
'브람스를 좋아하세요' 류보리 작가, 박은빈-김민재 캐릭터 소개	톱스타뉴스
'브람스' 측 "박은빈X김민재, 감정의 소용돌이 휩싸인다"	스포츠조선
종영 ‘브람스’ 김민재♥박은빈, 재결합 후 결혼약속... 꽉 닫힌 해피엔딩[종...	TV리포트
'브람스를 좋아하세요?' 박은빈X김민재, 공식 포스터 2종 공개	한국경제
셀러비, 프로골퍼 이지훈과 메인 스폰서쉽 체결해	데일리경제
셀러비, 프로골퍼 이지훈과 메인 스폰서쉽 체결해	데일리경제
‘브람스를 좋아하세요?’ 31일 첫 방송…감성 충만 관전포인트	스포츠동아
[그 옷 어디꺼] '브람스' 박은빈, 상큼 러블리한 오피스룩 어디꺼?	패션엔
‘브람스를 좋아하세요?’ 박은빈X김민재, 감정의 소용돌이 휩싸인다	한국경제
"이런 감성 기다렸다"…'브람스' 김민재X박은빈, 최고 시청률 7% 돌파	텐아시아
美 가장 비싼 원룸 임대료, 가파르게 하락…"덜 밀집된 지역으로 수요 이동"	조선비즈언론사 선정
피아니스트 백건우, 슈만의 젊음· 광기 담은 신보 발매	이데일리
트럼프, 긴즈버그 유언 조작 의혹 제기…"펠로시·슈머·시프가 썼을 수도"	뉴시스
'브람스를 좋아하세요?' 박은빈→김민재, 공식 포스터 2종 공개	뉴스1
[서병기 연예톡톡]‘브람스’ 송아와 준영의 감정선을 따라가기만 하면 된다	헤럴드경제
'브람스를 좋아하세요?' 박은빈→김민재, 공식 포스터 2종 공개	뉴스1
'브람스를 좋아하세요' 박은빈X김민재, 공감가득 관전 포인트 '넷'	텐아시아
[서병기 연예톡톡]‘브람스’ 송아와 준영의 감정선을 따라가기만 하면 된다	헤럴드경제
박은빈X김민재 ‘브람스를 좋아하세요?’ 종영, 2020년표 클래식 로맨스	브레이크뉴스
'결혼행진곡 멘델스존'만 기억하는 건 좀 서럽습니다	오마이뉴스언론사 선정
'브람스' 박은빈X김민재, 시작부터 더블 삼각관계로 강렬전개	MBC연예
'브람스를 좋아하세요' 박은빈·김민재, 이끌림 설렘↑…시청률 6.2%	더팩트
[문화소식] 바리톤 조규희·배우 서태화, '겨울나그네' 콜라보	연합뉴스
오피스텔 한채가 무려 115억…'한강'이 3년만에 25억 올렸다	중앙일보언론사 선정
소개팅에 레깅스 입고 가도 되나요?	조선일보언론사 선정
[문화소식] 바리톤 조규희·배우 서태화, '겨울나그네' 콜라보	연합뉴스
오피스텔 한채가 무려 115억…'한강'이 3년만에 25억 올렸다	중앙일보언론사 선정
소개팅에 레깅스 입고 가도 되나요?	조선일보언론사 선정
[글로벌-엔터 24] 카일리 제너·리한나·테일러 스위프트, 포브스서 가장 부유...	글로벌이코노믹
박은빈X김민재의 클래식 로맨스…'브람스를 좋아하세요?' 포스터 공개	SBS funE
‘브람스를 좋아하세요?’ 첫방 관전포인트 #공감 #음악 #사랑 [MK★미리보기...	MK스포츠
서비스나우, 신고가 경신하는 이유는? [SaaS기업 시리즈③]	한국경제언론사 선정
노점서 옷팔던 소녀가 6,000억 자산가로... 팝스타 리애나 '자수성가한 女갑부...	서울경제언론사 선정
`브람스를 좋아하세요?` 박은빈 김민재 박지현 김성철, 한 자리에 `묘한 분위...	MK스포츠
‘브람스’ 박은빈X김민재, 수줍은 눈빛 교환…묘한 인연의 시작	스포츠동아
`브람스를 좋아하세요?` 박은빈 김민재 박지현 김성철, 한 자리에 `묘한 분위...	MK스포츠
`브람스를 좋아하세요?` 공식 포스터 공개…박은빈X김민재 러브 콘체르토	MK스포츠
‘브람스’ 박은빈X김민재, 수줍은 눈빛 교환…묘한 인연의 시작	스포츠동아
'브람스' 류보리 작가 "박은빈 바이올린 연주, 음대생이라 해도 손색 없어"	싱글리스트
[포토]사랑의 쌀 나눔행사 참석한 클라라	아시아투데이
'브람스를 좋아하세요', 오늘(31일) 첫방…감성 충만 관전포인트 넷	엑스포츠뉴스
‘환상의 호흡’ 주미 강·손열음 듀오공연	세계일보
SM 카운티 보건명령 위반 단속	미주한국일보
전쟁 살인마·독가스의 아버지…그도 노벨상을 품었다	대구신문
‘브람스를 좋아하세요?’ 박은빈-김민재, 짝사랑 공감 3차 티저 공개	한국경제
‘브람스를 좋아하세요?’ 박은빈-김민재, 짝사랑 공감 3차 티저 공개	한국경제
책을 펼칠 때마다 잠자리, 나비 날개가···	서울경제
박은빈X김민재 ‘브람스’ 귀호강 드라마? 클래식+OST 음악 향연	뉴스엔
'브람스를 좋아하세요?' 박은빈X김민재, 공식 포스터 공개	한국일보
3월부터 야간통금해온 프랑스령 기아나 "코로나19 억제 효과적"	연합뉴스
'브람스를 좋아하세요?' 2회만에 안방극장 감성 올킬 '심쿵 명장면'	스포츠조선
'브람스를 좋아하세요?' 박은빈X김민재, 수줍은 눈빛 교환…묘한 인연의 시작	한국경제
[민사] "구글과의 앱 송사, 美 캘리포니아에서 해야"	리걸타임즈
‘브람스’ 측 “박은빈 김민재, 감정의 소용돌이 휩싸인다”[오늘TV]	뉴스엔
가주 놀이터 재개방 허용	미주한국일보
'브람스를 좋아하세요?' 박은빈X김민재, 클래식 로맨스…공식포스터 2종	헤럴드POP
‘브람스를 좋아하세요?’ 박은빈 김민재, 수줍은 눈빛 교환 ‘귀여운 케미’	한국경제TV
[민사] "구글과의 앱 송사, 美 캘리포니아에서 해야"	리걸타임즈
‘브람스’ 측 “박은빈 김민재, 감정의 소용돌이 휩싸인다”[오늘TV]	뉴스엔
가주 놀이터 재개방 허용	미주한국일보
박은빈·김민재 '브람스' 2회만에 안방극장 사로잡은 '심쿵 명장면'	이데일리
손열음X클라라 주미강, 듀오 리사이틀...4년만의 '워맨스'	싱글리스트
박은빈·김민재 짝사랑 6각 로맨스…'브람스를 좋아하세요' 3차 티저	이데일리
셀러비, 프로골퍼 이지훈 선수와 메인 스폰서쉽 체결	아시아경제
'브람스를 좋아하세요?' 오늘(31일) 첫방…관전포인트 공개 #공감 #음악 #사랑	마이데일리
‘브람스를 좋아하세요?’ 박은빈·김민재, 묘한 인연의 시작 [MK★TV컷]	MK스포츠
'브람스를 좋아하세요?' 박은빈♥김민재, 심장 남아나지 않는 '짝사랑의 공감...	스포츠조선
'브람스를 좋아하세요?' 측 "3각X3각 관계 가동될 것"	뉴시스
'브람스를 좋아하세요?' 김민재X박은빈, 달달 클래식 로맨스…메인 포스터 공...	엑스포츠뉴스
'브람스를 좋아하세요?' 오늘(31일) 첫방…관전포인트 공개 #공감 #음악 #사랑	마이데일리
‘브람스’ 박은빈X김민재, 서로에게 왜 끌렸나	뉴스엔
백건우, 어둠 밝히는 낭만음악 들고 귀환…'슈만' 발매	싱글리스트
[민병수]아시안이 무슨 변호사, 자동차 정비나 배워라	미주중앙일보
부국제 관객상 '페뷸러스', 개성만점 캐릭터 열전...1차 예고편 공개	싱글리스트
"10년간 맞춘 찰떡 호흡으로 라벨·스트라빈스키曲 선사"	한국경제
'브람스를 좋아하세요?' 박은빈-김민재-김성철-박지현, 한 자리에 '묘한 분위...	한국일보
‘브람스’ 박은빈·김민재, 수줍은 눈빛 교환으로 묘한 인연 시작!	스포츠경향
백건우, 어둠 밝히는 낭만음악 들고 귀환…'슈만' 발매	싱글리스트
'브람스를 좋아하세요?', 2회만에 감성 올킬…심쿵 명장면 넷	엑스포츠뉴스
[민병수]아시안이 무슨 변호사, 자동차 정비나 배워라	미주중앙일보
부국제 관객상 '페뷸러스', 개성만점 캐릭터 열전...1차 예고편 공개	싱글리스트
[오늘방송] '눈·귀 호강' 예고하는 박은빈X김민재 '브람스를 좋아하세요?'	디지틀조선일보
‘브람스를 좋아하세요?’ 티저, 친구의 친구를 사랑했네	뉴스엔
"10년간 맞춘 찰떡 호흡으로 라벨·스트라빈스키曲 선사"	한국경제
부안군, 판타지 댄스뮤지컬 호두까기 인형 29일 공연	뉴시스
"10년간 맞춘 찰떡 호흡으로 라벨·스트라빈스키曲 선사"	한국경제
'브람스를 좋아하세요' 박은빈X김민재, 아슬아슬한 6각 관계 예고	엑스포츠뉴스
부안군, 판타지 댄스뮤지컬 호두까기 인형 29일 공연	뉴시스
김민재X박은빈 '브람스를 좋아하세요?', 오늘(31일) 첫방 감성 충만 관전포인...	OSEN
'브람스를 좋아하세요?' 박은빈X김민재, 수줍은 눈빛 교환..묘한 인연 시작?!	헤럴드POP
네오위즈 브라운더스트, 새 조력자 업데이트	ZDNet Korea
'브람스를 좋아하세요?' 시청률 6.2% 기록…박은빈X김민재 첫방부터 터졌다	미디어펜
'브람스' 박은빈, 김민재 첫 만남..짝사랑 아픔 '브람스?' [★밤TView]	스타뉴스
손열음, '매진의 역설'로 취소됐던 리사이틀 연다	뉴시스
[리뷰] '브람스를 좋아하세요?'…클래식 선율 타고 피어나는 청춘 로맨스	한국경제
손열음, '매진의 역설'로 취소됐던 리사이틀 연다	뉴시스
[리뷰] '브람스를 좋아하세요?'…클래식 선율 타고 피어나는 청춘 로맨스	한국경제
“클래식 연주는 죽은 텍스트를 상상력으로 되살리는 작업”	중앙SUNDAY
‘브람스를 좋아하세요?’ 박은빈X김민재, 심장 남아나지 않는 ‘짝사랑 공감...	매일경제
KBS교향악단 "클래식 음악은 정서적 치유의 백신"	뉴시스
“코로나로 절간같은 집에 갇혀보니… 무대가 그립네요”	조선일보
'독서 삼매경' 클라라 "포기하지 마세요"...우아+세련美 가득 셀피 한 컷	화이트페이퍼
가주‘주택구입 여력’가구 33% 불과	미주한국일보
‘브람스를 좋아하세요?’ 박은빈 김민재, 3각X3각 관계 가동 ‘텐션UP’	스포츠동아
캘리포니아, LA 등서 ‘술집 영업’ 중단 명령	이데일리
캘리포니아, LA 등서 ‘술집 영업’ 중단 명령	이데일리
"부산웨딩페어 in 메리움웨딩명품관" 결혼준비 예비부부대상 30쌍한정 웨딩 혼...	잡포스트
[단독]일광그룹 이규태, 학교 돈 '수억원 횡령' 혐의 기소의견 송치	노컷뉴스언론사 선정
‘브람스를 좋아하세요?’ 박은빈 김민재, 3각X3각 관계 가동 ‘텐션UP’	한국경제TV
손열음, 취소됐던 피아노 리사이틀 공연 재개	파이낸셜뉴스
[취재파일] 방콕에 지친 당신을 위해(51) 손열음도 송가인도 방구석 1열에서	SBS
'브람스를 좋아하세요" 박은빈·김민재, 아슬아슬 6각 로맨스+짝사랑 예고	마이데일리
작가로의 성장기 재미있고 생동감 있게	미주한국일보
[타임머신] 선미 '흔든 건 골반이 아니라 서로의 인생' (TEN컷)	텐아시아
미ㆍ중 갈등에 글로벌 반도체 업계 M&A 가속화	이투데이
미ㆍ중 갈등에 글로벌 반도체 업계 M&A 가속화	이투데이
'브람스' 측 "3각X3각 관계 시작, 감정의 소용돌이 휩싸인다"	스포츠서울
영상만으로도…마음 울린 바이올린과 피아노	매일경제
'브람스를 좋아하세요?' 박은빈-김민재 서로를 향한 이끌림, '최고 시청률 7%...	스타데일리뉴스
“어느덧 10년… 손열음과의 연주, 혼자 무대처럼 편안~해요”	서울신문
서철모 화성시장, “시민과의 소통이 청렴도 높여”	더리더
'건반 위의 구도자' 백건우, 그가 슈만을 선택한 이유	오마이뉴스
[퍼스널리티] 사랑을 잡으려면 좀더 용기내줘요, 박은빈씨!	아이즈 ize
오늘(31일) 첫방 '브람스를 좋아하세요?', 감성 충만 관전포인트 #공감 #음악...	스타데일리뉴스
가주 학부모 65% “학교 안전 불안”	미주한국일보
'브람스를 좋아하세요?' 박은빈X김민재, 감성 올킬 '심쿵 명장면'	톱데일리
KBS교향악단, 26일 특별연주회 '시들지 않는 사랑'	이데일리
브라운더스트, 신규 조력자 4인 업데이트	게임조선
SJUSD, 12월까지 원격수업	미주한국일보
가주“네일 살롱도 실내 영업 허용”	미주한국일보
산마테오, SF, SC 감소세	미주한국일보
[드링킷] 스페인으로 랜선 여행 떠나는 방법	아시아경제
‘브람스를 좋아하세요?’ 박은빈‧김민재, 아련한 3각X3각 본격화 [M+TV컷]	MBN
'브람스를 좋아하세요?' 박은빈x김민재, 6각 로맨스 "친구의 친구를 ♥했네"	OSEN
'브람스를 좋아하세요?' 오늘(31일) 첫방송, '클래식 로맨스' 관전포인트	조이뉴스24
'브람스를 좋아하세요?' 오늘(31일) 첫방송, '클래식 로맨스' 관전포인트	조이뉴스24
브라운더스트, 신규 조력자 4인 업데이트	게임샷
'브람스를 좋아하세요?' 박은빈X김민재, 수줍고 설레는 인연 시작	서울경제
서철모 화성시장, "시민과의 소통이 청렴도 높여"	이뉴스투데이
백건우 “제 손으로 짐싸서 정신병원 걸어들어간 슈만, 이제 이해”	중앙일보
부국제 관객상 '페뷸러스', 러블리 여성 영화...캐릭터 포스터 공개	싱글리스트
'브람스를 좋아하세요' 공식 포스터 공개…박은빈X김민재 클래식 로맨스	조이뉴스24
유주현이 만난 아트 인플루언서(4) 피아니스트 손열음	포브스코리아
SF 180여곳 놀이터 재개방	미주한국일보
'브람스' 김민재, 브람스 싫어하는 이유 밝혀졌다..."친구의 애인 사랑해"	조이뉴스24
슈만으로 돌아온 백건우…"모든 이의 아픔 담은 선율로 청중 위로"	한국경제
네오위즈 브라운더스트 신규 조력자 4인 업데이트	EBN
SF 180여곳 놀이터 재개방	미주한국일보
'브람스' 김민재, 브람스 싫어하는 이유 밝혀졌다..."친구의 애인 사랑해"	조이뉴스24
시민과 通하는 화성시장... 1135개 제안 시정에 반영	중도일보
할리우드 배우 캐머런 “하나님 백성들 깨어나야”	크리스천투데이
'브람스' 박은빈, 시청자 마음 두드린 감성 내레이션..몰입도甲	헤럴드POP
예술의전당 공연중단 기간 연장…김선욱 피아노 연주회 연기	매일경제
서철모 화성시장 "좋은정책 행정신뢰 없으면 소용 없다"	스포츠서울
손열음 ‘오로지 슈만’만 친다…매진의 역설로 취소됐던 독주회 재개	아이뉴스24
“난 아직도 슈만이 절실하다”	조선일보
‘브람스’ 박은빈 과거 시점 내레이션에 쏠리는 관심	뉴스엔
베이지역 확진자수 9만5천여명	미주한국일보
'운동 삼매경' 클라라 "운동만 집중해야 운동이 잘됩니다" 들여다보니?	화이트페이퍼
[우리 이웃 이야기] 오전동본당 최고령 영세자 95세 최길자 어르신	가톨릭신문
베이지역 고용 회복 지지부진	미주한국일보
네오위즈 브라운더스트 신규 조력자 4인 추가	NSP통신
'브람스를 좋아하세요?' 박은빈-김민재, 3각X3각 관계 본격 가동 "감정의 소용...	SBS funE
'브람스를 좋아하세요?' 박은빈X김민재, 꽉 닫힌 해피엔딩…최고 시청률 7.4%	싱글리스트
피아니스트 최현아, 예술의전당서 독주회…"청량한 음악"	뉴시스
'브람스를 좋아하세요?' 박은빈X김민재, 꽉 닫힌 해피엔딩…최고 시청률 7.4%	싱글리스트
피아니스트 최현아, 예술의전당서 독주회…"청량한 음악"	뉴시스
젠슨 황 CEO, 'AI 시대'를 이끄는 엔비디아의 기술력 소개	테크월드
'브람스' 박은빈-김민재, 3각X3각 관계 가동 '감정의 소용돌이'	enews24
'브람스를 좋아하세요?' 박은빈X김민재, 짝사랑의 감정 공유한 두 사람의 만남	서울경제
서철모 화성시장, 제10회 세계인권도시포럼 참여	경기도민일보
성북구, 4차 산업혁명 IT기술 보유한 벤처기업 육성 '총력'	머니투데이
“예배 벌금 2억 이상” 美 목회자, 카운티 상대 소송 제기	크리스천투데이
피아니스트 백건우, 더블 앨범 '슈만'으로 돌아온다	뉴스토마토
“슈만의 로맨틱한 음악 넘어 진짜 삶을 봤다”	서울신문
“음악과 함께 있을 때 살아 있음을 느낍니다”	세계일보
[더파워] SBS 월화드라마 ‘브람스를 좋아하세요?’ 박은빈 김민재, 사랑과 우...	더파워
마린 카운티 경제 재개 미뤄져	미주한국일보
박은빈X김민재 ‘브람스를 좋아하세요?’, 오늘 첫방..관전포인트는?	브레이크뉴스
서철모 화성시장 "시민과의 소통이 청렴도 높여" 강조	뉴스핌
친구의 친구를 사랑한 ‘브람스를 좋아하세요?’ [볼까말까]	쿠키뉴스
세계인권회의 참석 서철모 화성시장 "신뢰받는 행정 가장 중요"	경인일보
가주 코로나19 증가율 둔화세	미주한국일보
백건우 “자기 손으로 짐싸서 정신병원 걸어들어간 슈만, 이제 이해”	중앙일보
김태연 주무관 "학교 밖 청소년들, 교육재난지원금 오는 11일까지 신청하세요...	BBS NEWS
산불경고령에 수만가구 단전	미주한국일보
한인 간호사 교통사고 사망	미주중앙일보
男의 시선 벗고… 자신의 벗은 몸 직접 그린 최초의 女화가	문화일보
샌프란시스코 총영사관 개천절 행사	미주중앙일보
'브람스' 박은빈X김민재, 묘한 인연→수줍 눈빛교환 '역대급 케미'	조이뉴스24
수원문화재단, ‘코로나19 거리두기 2.5단계’ 발표에 프로그램 일정 변경	경기신문
피아니스트 손열음 4년만에 독주회 '슈만의 곡으로만 채운다'	아시아경제
서철모 화성시장 “시민소통 통한 행정 신뢰도 회복..청렴도시의 첫발”	헤럴드경제
박은빈X김민재 클래식 로맨스 ‘브람스를 좋아하세요?’, 31일 첫 방송	브레이크뉴스
브라운더스트, 신규 조력자 4인 업데이트	로이슈
엔비디아, 새로운 GPU 2종 출시	더게임스데일리
'브람스' 박은빈·김민재, 친구의 친구를 사랑했네…6각 로맨스 티저	조이뉴스24
믿을 수 있는 가톨릭 건강 식품에 정성을 담아	가톨릭평화방송·평화신문
'브람스를 좋아하세요?' 박은빈-김민재, 3각X3각 관계 시작 된다	톱데일리
호매실장애인종합복지관, 장애 이해 UCC 공모전	가톨릭신문
서철모 화성시장, “청렴도 상승 비결은 시민과의 소통”	NSP통신
세일즈 텍스 인상안 상정 불발	미주한국일보
코로나19 재급증할까 우려	미주한국일보
손열음, 취소됐던 피아노 리사이틀 공연 재개 '손열음 연주로 만나는 슈만'	문화뉴스
'브람스를 좋아하세요?' 첫방! 박은빈x김민재, 감성 충만 '클래식 로맨스' 관...	엔터미디어
