트럼프·바이든 내일 마지막 TV토론…음소거 누구한테 유리할까	연합뉴스언론사 선정
유리 겔러 사기극 밝혀낸...마술사 잡은 마술사, 하늘로	조선일보언론사 선정
제천 용추폭포 유리전망대 신규 '숨은 관광지' 선정	뉴시스
유리, 연극 '앙리할아버지와 나' 합류, 콘스탄스 役	한국경제
김해서 발견된 가야시대 유리 목걸이 3건 보물 됐다	연합뉴스
소녀시대 유리, 연극 '앙리할아버지와 나' 재연 합류…"정말 기뻐" 소감	마이데일리
이재용 만난 베트남 총리 "삼성의 첨단 프로젝트 투자 계획, 유리한 조건 준비...	조선비즈언론사 선정
나이지리아 내정 ‘혼돈 속으로’… 유명희에 유리?	세계일보언론사 선정
‘유리한 식탁’ 유리, ‘연반인’ 재재와 특급 만남 성사	스포츠동아
사전투표 열기, 바이든 유리한줄 알았는데… 공화도 ‘막판 결집’	동아일보언론사 선정
"한수원, 월성1호기 가동중단에 유리하도록 '경제성' 저평가"	시사저널언론사 선정
'LA댁' 쿨 유리, 폭풍성장 삼남매에 뿌듯 "패딩 너무 예뻐" [★해시태그]	엑스포츠뉴스
신혼특공 vs 생애최초특공…어떤 게 유리할까?	매경이코노미언론사 선정
미 대선 역대급 사전투표, 누구에게 유리할까	데일리안언론사 선정
기업들 "좋은 학벌이 채용, 입사후에도 유리"	중소기업뉴스
美대선 2주 앞으로…높은 사전투표율, 누구에게 유리할까	한국경제
유리처럼 투명한 태양전지	YTN사이언스
[단독] 軍도 우려했는데…방사청, 수리온에 유리한 의견 냈다	국민일보언론사 선정
유리 합류, 꽃다발 들고 여신미모 인증샷 눈길 "덕분에 행복"	일요신문
김경협 “기재부 세법 해석이 대기업·고소득자에 유리하게 작용”	한겨레
[美 대선] 사전투표 4천만명 넘어···'민주당에 유리한 신호?'	오피니언뉴스
연말까지 조정받으면 `매수` 유효..코스닥보다 코스피 유리	이데일리
소녀시대 유리, 러블리 매력 뚝뚝 일상	한국일보
‘피로회복제에 유리조각’ 신고…업체 “유통상 문제일 것”	메디컬투데이
글라스락 베이비 세이프 유리식기 등 체험단 모집	파이낸셜뉴스
3박자(친환경·경제성·내구성) 갖춘 'FRP(강화유리섬유) 수영장'	경인일보
소녀시대 유리, 고품격 미모…'아우라 남다르네'	마이데일리
소녀시대 유리, 갈수록 더 예뻐져..빛나는 명품 비주얼	헤럴드POP
“유리천장 상존”…경북 공공기관 26곳 중 22곳 여성비율 절반 못미쳐	중앙일보
충북에서 건물 일체형 태양광 유리 생산된다	프레시안
[IS 수원] LG 7-6 승리, 2위 싸움 유리한 고지…KT 5위 추락	일간스포츠
깨진 시내버스 전면 유리	연합뉴스
청주 차량 유리 정비업체서 불…버스 3대 일부 소실	노컷뉴스
산업부 “월성 1호기 가동 중단에 유리한 관여 없었다”	세계일보
[노컷영상] 대형 오픈마켓 유리캔들 충격 완충재 하나 없이 배송해 산산조각	소비자가 만드는 신문
여전한 유리천장…금융공기업 9개 중 8개 여성임원 ‘0’	SBS CNBC
반기문 평화기념관, '유리공예' 전 열어	충청일보
[2020 美대선 D-12] 2300조원 부양책, 누구에게 유리할까	e대한경제
청주 자동차 유리업체 주차장 버스 불…인명피해 없어	뉴시스
[속보]감사원"월성1호 계속 가동 유리함에도 낮은 이용률 전망"	파이낸셜뉴스언론사 선정
파라핀으로 코팅한 유리, 물·먼지도 튕겨낸다	파이낸셜뉴스언론사 선정
인터넷가입 및 티비(TV)결합상품 현금지원 사은품많이주는 사이트가 유리 할 ...	월간원예
[사진]구자욱 파울타구에 깨진 스카이박스 유리	OSEN
삼광글라스, ‘세이프 유리식기·스낵뚜껑 흡착볼’ 체험단 모집	아시아경제
LH, 여성관리자 비율 3년내 두 배로…'유리천장' 깬다	CEO스코어데일리
LH, 고객만족 설문조사 유리한 결과내려 '우호고객' 동원해 왜곡	조선비즈언론사 선정
K5 2021년형 출시… 리모트 360도 뷰 기능 탑재, 차음유리 하위 트림도 장착	문화일보
권익위 '스카이72골프장 민법상 임대차 계약'으로 봐야…스카이72 1천500억원...	경기일보
여성 고위공무원, 검찰 1명·법무부 2명…유리천장 여전	뉴시스언론사 선정
금융 '유리천장' 여전…임원 별따기·임금격차 심각	한국정책신문
'임찬규 10승' LG, 2위 굳히기 유리한 고지 점령…KT 5위 추락	뉴스1
제천시 의림지 '용추폭포 유리전망대' 한국관광공사ㆍ문광부 신규개방 관광지...	브레이크뉴스
[더오래]보물된 1700년 전 가야의 유리 구슬 목걸이	중앙일보
CCTV 임종, 유리문에 쓴 “사랑해”…속수무책 ‘코로나 이별’	한겨레언론사 선정
쇠구슬로 미용실·차량 유리 파손…"CCTV엔 깨지는 장면만 포착"	연합뉴스언론사 선정
역대급 '조기 투표' 열기…누구에게 유리할까?	MBC언론사 선정
쿨 유리 "넷째도 갖고 싶다" 귀여움 가득한 삼남매 [★해시태그]	엑스포츠뉴스
[2020 국감] 구글 자사에 유리한 여론 조성 위해 갑질?	이투데이
[2020국감] 수협, 유리천장 여전…임원 54명 중 여성임원 고작 3명	뉴스핌
'나는 몸신이다' 쿨 김성수x김재환 몸신, '이소성 지방'과 혈중 유리지방산 검...	엔터미디어
“檢이용해 정권에 유리한 프레임 작업을 법무장관이 자처”	문화일보
소녀시대 유리X채수빈X박소담, 연극 '앙리 할아버지와 나' 합류…12월 개막	조이뉴스24
유리, `누가 뭐래도` OST 합류…18일 공개	매일경제
소녀시대 유리, 거울 셀카도 그냥 찍지 않아..세련美 가득해♥	헤럴드POP
“10위 부산이 잔류 경쟁 가장 유리? 유관중이 변수다” [엠스플 축구]	엠스플뉴스
신수원 감독, ‘유리정원’ 이후 3년만에 인사드립니다[포토엔HD]	뉴스엔
추미애 장관이 서울시장 나오면…서민 "野 유리한 일이 될 것"	매일경제언론사 선정
발수코팅 유지력 "굿" 자기회복 자기세정 유리	이웃집과학자
'미국댁' 쿨 유리, 셋도 부족해 넷째 갖고픈 '46세 다둥맘'…"4호도 갖고싶네...	스포티비뉴스
11조에 낸드사업 매각한 인텔…삼성전자와 경쟁 피하는게 유리?	뉴시스
돈으로 코로나 탈출…선진국이 유리하다	머니투데이
음성파일도 있다는데…檢, 고민정 유리한 진술만 듣고 불기소	중앙일보
“환경·소음에 더 유리”…첨단화·현대화가 해법	KBS
세종시 종횡무진한 멧돼지…상가 유리 '와장창'	MBC언론사 선정
[철&민 부동산백서]신혼부부 특공? 신혼희망타운?…뭐가 유리할까요	뉴스1언론사 선정
운전 중 앞유리로 쇳덩어리가 '쾅'…운전자 '구사일생'	한국경제언론사 선정
제약바이오 여성 임원 10명 중 1명꼴...견고한 유리천장	데일리팜
호주 질병센터 "코로나, 지폐나 유리표면서 최장 28일간 생존"	노컷뉴스언론사 선정
[단독]김동연 출마 고사… 野 “판은 유리한데…인물이 없어”	동아일보언론사 선정
MLB닷컴 "탬파베이 WS 상대? 다저스보다 애틀랜타가 유리해"	뉴스1
세종 도심 출몰 멧돼지 상가유리 깨…인명피해 없으나 시민 불안	연합뉴스언론사 선정
새총으로 미용실 유리 파손한 50대 구속	MBC
미 명문대 '포괄적 평가', 부자 엘리트에게 유리했다!	뉴스톱
"학교 앞서 술 파는 게 뭐가 문제냐"…구청 유리 깬 민주노련	한국경제언론사 선정
오랜만에 투자 기지개 토종 유리기업 '한글라스'	서울경제
제천시 의림지 '용추폭포 유리전망대' 가을철 '숨은 관광지'에 선정	경인매일
유리 여닫이문으로 둘러싸인 본채	연합뉴스
[10월 21일 워크넷 채용정보] (주)파인텍·주식회사 쉘보드·동일유리(주)·(...	뉴스투데이
대한체육회 여성임원 16%, 3급 이상 0명...체육계 유리천장 심각 	여성신문언론사 선정
日싱크탱크 "이번 美대선은 코로나 선거…민주당에 유리"	뉴스1
[사설] 불리하면 “거짓말” 유리하면 “신빙성 있다”, 정권의 이중성	매일신문언론사 선정
[르포] 1600℃ 유리물이 주르륵…파유리는 최대 점보유리가 됐다	아시아경제언론사 선정
野 "유리한 지표 위해 통계조작"…통계청장 "전혀 공감 못해"	연합뉴스
[리뷰]유리 자전거와 함께하는 혈압 마라... 아니 사이클 '사이클 질주 본능 ...	게임포커스
조선왕실 사각 유리등 문화상품 발매	연합뉴스
장기근속 중기 근로자, 특공 유리해진다…재직기간 배점↑	뉴시스
유리 장식에 부적을? 위트로 런던 사로잡은 한국 공예	중앙일보
국세청, 유리천장‧성차별 심각... "4급 승진 3년 넘게 차이"	여성신문언론사 선정
치매도, 유리문도 뛰어넘는 노부부의 사랑	충청투데이
막오른 잔여경기 시즌…2위싸움 경우의 수 가장 유리한 건 KT?	스포츠경향
신수원 감독, ‘유리정원’ 이후 3년만에 인사드립니다[포토엔HD]	뉴스엔
추미애 장관이 서울시장 나오면…서민 "野 유리한 일이 될 것"	매일경제언론사 선정
삼광글라스 ‘세이프 유리식기 & 스낵뚜껑 흡착볼’ 출시 기념 체험단 모집	로이슈
유리, ‘누가 뭐래도’ 메인 타이틀곡 ‘인생은 아름다워’ 가창	스포츠동아
소녀시대 유리, 연극 '앙리할아버지와 나' 합류…"무척 영광이고 감격스럽다"	뉴스인사이드
발수코팅 유지력 "굿" 자기회복 자기세정 유리	이웃집과학자
'미국댁' 쿨 유리, 셋도 부족해 넷째 갖고픈 '46세 다둥맘'…"4호도 갖고싶네...	스포티비뉴스
11조에 낸드사업 매각한 인텔…삼성전자와 경쟁 피하는게 유리?	뉴시스
돈으로 코로나 탈출…선진국이 유리하다	머니투데이
음성파일도 있다는데…檢, 고민정 유리한 진술만 듣고 불기소	중앙일보
음성파일도 있다는데…檢, 고민정 유리한 진술만 듣고 불기소	중앙일보
“환경·소음에 더 유리”…첨단화·현대화가 해법	KBS
오염물 튕겨내는 자기회복·자기세정 다기능 유리 개발	뉴스1
[전시] 반기문 평화기념관 기획전 '유리 공예 전(展), 평화의 숨결을 불어넣다...	뉴스티앤티
'다둥맘' 쿨 유리, 귀여움 가득한 삼남매에 "넷째도 갖고파"[스타IN★]	스타뉴스
세종시 종횡무진한 멧돼지…상가 유리 '와장창'	MBC언론사 선정
[철&민 부동산백서]신혼부부 특공? 신혼희망타운?…뭐가 유리할까요	뉴스1언론사 선정
운전 중 앞유리로 쇳덩어리가 '쾅'…운전자 '구사일생'	한국경제언론사 선정
제약바이오 여성 임원 10명 중 1명꼴...견고한 유리천장	데일리팜
호주 질병센터 "코로나, 지폐나 유리표면서 최장 28일간 생존"	노컷뉴스언론사 선정
제약바이오 여성 임원 10명 중 1명꼴...견고한 유리천장	데일리팜
호주 질병센터 "코로나, 지폐나 유리표면서 최장 28일간 생존"	노컷뉴스언론사 선정
[단독]김동연 출마 고사… 野 “판은 유리한데…인물이 없어”	동아일보언론사 선정
MLB닷컴 "탬파베이 WS 상대? 다저스보다 애틀랜타가 유리해"	뉴스1
세종 도심 출몰 멧돼지 상가유리 깨…인명피해 없으나 시민 불안	연합뉴스언론사 선정
새총으로 미용실 유리 파손한 50대 구속	MBC
미 명문대 '포괄적 평가', 부자 엘리트에게 유리했다!	뉴스톱
"학교 앞서 술 파는 게 뭐가 문제냐"…구청 유리 깬 민주노련	한국경제언론사 선정
쇠구슬로 미용실·차량 유리 파손…"CCTV엔 깨지는 장면만	SBS
오랜만에 투자 기지개 토종 유리기업 '한글라스'	서울경제
제천시 의림지 '용추폭포 유리전망대' 가을철 '숨은 관광지'에 선정	경인매일
유리, '누가 뭐래도' OST 참여…'인생은 아름다워' 18일 공개	OSEN
유리 여닫이문으로 둘러싸인 본채	연합뉴스
음성 반기문 평화기념관, '제6회 기획전시 유리공예 전(展) 평화의 숨결을 불...	대전일보
벌레잡이통풀 닮은 오염물 튕겨내는 유리 개발	연합뉴스
[10월 21일 워크넷 채용정보] (주)파인텍·주식회사 쉘보드·동일유리(주)·(...	뉴스투데이
대한체육회 여성임원 16%, 3급 이상 0명...체육계 유리천장 심각 	여성신문언론사 선정
日싱크탱크 "이번 美대선은 코로나 선거…민주당에 유리"	뉴스1
새총으로 지인 미용실 유리 파손 50대 구속	SBS
[사설] 불리하면 “거짓말” 유리하면 “신빙성 있다”, 정권의 이중성	매일신문언론사 선정
반기문 평화기념관, 제6회 기획전시 '유리공예 전(展), 평화의 숨결을 불어넣...	중도일보
새총으로 지인 미용실 유리 파손 50대 구속	SBS
오염물 튕겨내고 흠집 덮는 '자기세정·회복 유리' 개발	헬로디디
[사설] 불리하면 “거짓말” 유리하면 “신빙성 있다”, 정권의 이중성	매일신문언론사 선정
'조국흑서' 서민 "추미애 서울시장? 야당에 되게 유리한 일"	머니투데이
[르포] 1600℃ 유리물이 주르륵…파유리는 최대 점보유리가 됐다	아시아경제언론사 선정
野 "유리한 지표 위해 통계조작"…통계청장 "전혀 공감 못해"	연합뉴스
[리뷰]유리 자전거와 함께하는 혈압 마라... 아니 사이클 '사이클 질주 본능 ...	게임포커스
조선왕실 사각 유리등 문화상품 발매	연합뉴스
장기근속 중기 근로자, 특공 유리해진다…재직기간 배점↑	뉴시스
[리뷰]유리 자전거와 함께하는 혈압 마라... 아니 사이클 '사이클 질주 본능 ...	게임포커스
조선왕실 사각 유리등 문화상품 발매	연합뉴스
장기근속 중기 근로자, 특공 유리해진다…재직기간 배점↑	뉴시스
수원 미용실에 날아든 쇠구슬 '유리문 와장창'…경찰 수사	뉴스1
유리 장식에 부적을? 위트로 런던 사로잡은 한국 공예	중앙일보
국세청, 유리천장‧성차별 심각... "4급 승진 3년 넘게 차이"	여성신문언론사 선정
치매도, 유리문도 뛰어넘는 노부부의 사랑	충청투데이
새총으로 미용실 유리 파손한 50대 구속…“과거 다툼에 앙심”	KBS
막오른 잔여경기 시즌…2위싸움 경우의 수 가장 유리한 건 KT?	스포츠경향
[위기의 야당②] "정치환경, 與에 압도적으로 유리"…'사면초가' 국민의힘	데일리안언론사 선정
기계연, 스스로 오염 제거하고 상처 회복하는 유리 개발	충청투데이
수원서 쇠구슬로 미용실·차량 유리 파손…경찰 수사	더팩트
'​앙리할아버지와 나' 이순재→소녀시대 유리·박소담까지, 역대급 캐스팅 완...	스포츠투데이
유리, '누가 뭐래도' OST Part.1 '인생은 아름다워' 가창…긍정 에너지 전달	마켓뉴스
“정부, 유리한 통계만 취해 부동산 양극화 감춘다”	세정신문
유명순 한국씨티은행장 후보 추천…유리천장 깼다	한겨레언론사 선정
오염물질 튕겨내고 스크래치에도 자기세정 가능한 유리 개발 성공	산업일보
감독들이 답했다, KIA·롯데 10경기-키움 2경기 누가 유리할까 [★이슈]	스타뉴스
쿨 유리, 옷걸이가 명품이야..남다른 패션 센스 애셋맘	헤럴드POP
[김정희원의 당신곁에서] 유리천장에 비친 여성혐오의 민낯	여성신문언론사 선정
쿨 유리, 옷걸이가 명품이야..남다른 패션 센스 애셋맘	헤럴드POP
[김정희원의 당신곁에서] 유리천장에 비친 여성혐오의 민낯	여성신문언론사 선정
손병석 코레일 사장 "고속철도 통합 방안이 더 유리하다 생각"	뉴시스
"국민 주거 수준, 정부가 유리한 통계만 발표"…실상은 양극화 '심화'	뉴스1
삼광글라스, 세이프 유리식기&스낵뚜껑 흡착볼 체험단 모집	아시아투데이
유리온실 커피로 억대 소득 청년…화순 마이크로맥스 차상화 대표	농업경제신문
"과학계 유리천장 여전…여성 신규채용 느는데 관리직은 10%뿐"	연합뉴스
美 '뜨거운' 사전투표 열기…"민주당 유리? 장담은 못해"	한국경제
'왜 경적 울려'…길 가던 60대 보행자가 둔기로 차 유리 부숴	TV조선언론사 선정
반기문 평화기념관, 제6회 기획전시…유리공예 전(展), 평화의 숨결을 불어넣...	충청투데이
삼광글라스, '세이프 유리식기&스낵뚜껑 흡착볼' 체험단 모집	메트로신문
손병석 한국철도공사 사장 “코레일, SR 통합이 철도 공공성에 더 유리”	경향신문
오염물 튕겨내고 상처 스스로 회복하는 '자기 세정 유리' 개발	노컷뉴스
[단독]국세청 최근 5년 동안 고위직 승진자에 여성 無…유리천장 심각	아시아경제언론사 선정
일동제약,'NASH 신약' 연관 물질특허 취득… "유리한 개발 요건 갖춰"	메디소비자뉴스
유리, KBS1 새 일일 '누가 뭐래도' 메인 타이틀곡 '인생은 아름다워' 가창	스타데일리뉴스
미 대선, 4년전보다 급감한 부동층…트럼프보다 바이든에 유리?	연합뉴스
기계연구원, 저절로 세정되고 스크래치 회복되는 유리 개발	헬로티
글람(GLAAM)-ANC, 투명LED유리 시장 활성화를 위한 전략적 MOU 체결	머니투데이
[오늘의 운세] 86년생, 주변 상황이 자신에게 유리하다	세이프타임즈
김종철 "대우조선 이익 떨어뜨려 현중으로 인수 유리하게 하는 의도"	뉴스1
[2020국감] 검찰청·법무부 '유리천장'…여성 고위공무원 수 턱없이 모자라	아시아경제
LG 승부수 '윙'에 '짠물' 보조금…선택약정이 유리	한국경제언론사 선정
쿨 유리, 명품 옷+신발 신고 러블리 매력 자랑..너무 사랑스러워	헤럴드POP
4대 민간은행 여성임원 고작 8명, 금융권 유리천장은 왜 안 깨지나	비즈니스포스트
국세청 남녀 승진 격차 최대 38개월… 김주영 “성차별·유리천장 있나?”	세계일보언론사 선정
경륜 베팅 전략, 이분법으로 접근 방법 유리	일간스포츠
‘문명특급’ 재재 “지소영소앞소” 소녀시대 유리 만나 찐팬 인증	뉴스엔
농협, 유리천장 여전… 임원 126명 중 여성 임원 2명	세계일보
"'유리천장'을 깬 중국 틱톡…국내도 AI 창업·투자 늘려야"	이데일리
소녀시대 유리, 논현동 128억 건물주 됐다	스포츠동아
'유리판 그린' 정복한 자, 최고 타이틀 주인 된다	전자신문
유리 '이미테이션' 캐스팅..."새로운 영역에 도전, 긴장되지만 설렌다"	톱데일리
'더불어' 잊어가는 민주당...'불리하면 침묵ㆍ유리하면 힘으로'	한국일보언론사 선정
"미용실로 날아든 쇠구슬…유리문·차량 파손" 수원서부서 수사	경인일보
씨티그룹 첫 여성 CEO 등장, 미국 월가 '유리천장'에도 균열 시작되다	비즈니스포스트
"과거 다툼에 앙심"…새총으로 미용실 유리 파손 50대 구속	연합뉴스
사모펀드 총공세... 여권에 유리한 정치지형 바뀌나?	오마이뉴스
국세청 '유리천장'…3급이상 여성승진자 2017년 이래 '0명'	연합뉴스
한국기계연구원, 고체윤활제 이용 자기세정 태양전지용 커버 유리 개발	기계신문
조선왕실 밤잔치에 쓰던 '사각 유리등' 내 방에도 들여볼까	파이낸셜뉴스
오염물질 튕겨내고 스크래치 자동복원…똑똑한 유리 나왔다	헤럴드경제
DAVEN, 블랙 미들타워 PC 케이스 FT305 강화유리 출시 및 이벤트 진행	케이벤치
'특공' 문턱 낮췄다…신혼? 생애최초? 뭐가 유리할까[부릿지]	머니투데이
트럼프 ‘유권자 등록 급증’ vs 바이든 ‘조기,우편 투표 유리’	라디오코리아
아이폰12 출시..중고 아이폰, 개인간 거래보다 ‘중고나라’가 유리	이데일리
경찰 내 유리천장 여전... 고위직 여경 3% 불과	여성신문언론사 선정
소녀시대 유리, 128억 건물주 됐다	텐아시아
“아직 우리가 유리해” 최지만, ALCS 6차전 설욕 다짐	스포츠경향
세종 도심에 멧돼지 출몰…상가유리 깨고 달아나	한국경제TV
세종 도심에 멧돼지 출몰…상가유리 깨고 달아나	한국경제TV
삼광글라스, '세이프 유리식기·스낵뚜껑 흡착볼' 출시 기념 체험단 모집	싱글리스트
[영어] 유리하다, 우위를 점하다	부산일보
소녀시대 유리, 건물주 대열 합류..128억원에 건물 매입	일간스포츠
기계연, 자기회복·자기세정 유리 개발	신소재경제신문
[문화소식] 조선왕실 사각 유리등 문화상품 발매	연합뉴스
[W프런티어]"유리천장 하소연 전에…능력과 실적으로 말하라"	아시아경제
국세청 유리천장 여전…3년동안 3급이상 승진 여성 ‘0명’	KBS
‘벌레·유리’ 나왔는데 식품안전 인증 ‘그대로’···SPC삼립·롯데제과·...	경향신문언론사 선정
달리는 차 앞유리 뚫은 쇳덩이 아찔…또 판스프링?	한국경제TV언론사 선정
‘벌레·유리’ 나왔는데 식품안전 인증 ‘그대로’···SPC삼립·롯데제과·...	경향신문언론사 선정
달리는 차 앞유리 뚫은 쇳덩이 아찔…또 판스프링?	한국경제TV언론사 선정
소녀시대 유리 건물주 됐다…논현동 5층 빌딩 128억 매입	한국경제
기계연, 자기회복 가능한 자기세정 유리 개발	충청뉴스
한밤중 유리창 깨고 유리문 뜯고 금은방 턴 간 큰 50대	매일경제
중소기업 장기 재직자, 특공 유리해진다	e대한경제
34년 기업금융 한우물 판 뱅커, 은행 유리천장 깼다	매일경제언론사 선정
학교 앞서 술파는 불법 노점 철거에 구청 유리 깨고 난동부린 민주노련	한국경제
술 취해 둔기로 차량 유리 내려친 60대 영장	KBS
美 부동층 4년 전의 절반…역시 바이든에 유리?	연합뉴스TV
청약보단 공모주펀드가 수익률 유리…빅히트도 통할까	연합뉴스언론사 선정
지방직 관리자급 공무원 유리천장 여전	충북일보
소녀시대 유리, 128억 논현동 건물주 됐다	스포츠서울
野 "유리한 지표 위해 통계조작"…통계청장 "전혀 공감 못해"	파이낸스투데이
삼광글라스, 환경 전시회 참가…"유리 소재로 환경 보호"	MTN
올수능은 재수생이 유리? 9월 모의평가 보니 격차 없었다	머니투데이
유리, ‘누가 뭐래도’ 메인 타이틀곡 ‘인생은 아름다워’ 가창..18일 발표	브레이크뉴스
제천시 의림지 '용추폭포 유리전망대', 가을철 숨은 관광지 선정	충청리뷰
안예은, '복면가왕' 반지원정대?…프리스타일 미노와 노래 대결+유리잔 연주	스포츠한국
소녀시대 유리, 논현동 건물주 됐다…128억 원에 매입	SBS funE
소녀시대 유리, 논현동 건물주 됐다…128억 원에 매입	SBS funE
기계연, 스스로 오염물 제거하는 유리 개발..."태양전지 활용 기대"	뉴스핌
"경적 왜 울려"…둔기로 차량 앞 유리 파손한 60대 체포	뉴스1
수원이혼전문변호사 “객관적인 자료 토대로 재산분할 유리하게 선점해야”	공감신문
소녀시대 유리, 128억 논현동 빌딩 건물주 됐다	매일경제
(2020 국감) "검찰청·법무부 유리천장 여전"…여성고위공무원 턱 없이 모자라	뉴스토마토
[Pick] 누리꾼 열광에…조선 왕실 '사각 유리등' 전격 상품 출시	SBS
"탬파베이의 WS 파트너, LAD보다 ATL이 더 유리" MLB.com	OSEN
벌레·유리 나와도 안심?…식품안전기준 인증 취소 '전무'	연합뉴스
아이폰 '중고' 언제 팔면 좋을까...사는 건 신형 출시후 '유리'	오피니언뉴스
벌레·유리 나와도 안심?…식품안전기준 인증 취소 '전무'	연합뉴스
아이폰 '중고' 언제 팔면 좋을까...사는 건 신형 출시후 '유리'	오피니언뉴스
한글라스, 코팅유리 브랜드명 바꾼다	국토일보
기계연, 벌레잡이통풀 닮은 오염물 튕겨내는 유리 개발	연합뉴스
美 사전 투표 열기 '후끈'…바이든에 유리?	OBS
공공기관도 유리천장…관리자 중 여성은 20% 미달	참세상언론사 선정
3급 이상 여성승진자 2017년 이래 '0명'…국세청 유리천장 두껍다	세정신문
소녀시대 유리, 논현동 128억대 건물주됐다	스타뉴스
'자동차 유리로 목걸이를'…현대차 업사이클링 프로젝트 공개	연합뉴스
문화상품으로 재탄생한 조선왕조 밤잔치용 사각 유리등	세계일보
식품에서 벌레·유리 나왔는데…해썹 유지?	뉴시스
‘강등 후보’ 인천-성남-부산, 남은 일정과 승점 유리한 팀은?[K리그 기상도...	스포츠한국
인터넷가입 및 티비(TV)결합상품 현금지원 사은품많이주는곳, 비교사이트 유리...	월간원예
유리천장 높은 국세청…2017년 이후 여성 3급 승진 ‘전무’	부산일보
세종 도심에 멧돼지 1마리 츌몰…상가유리 깨고 달아나	매일경제
화이트스톤, 스마트폰 강화유리 돔글라스·프로텍션 제품으로 국내외 시장 주...	머니투데이
유리, '누가 뭐래도' 주제곡 가창자 발탁…'인생은 아름다워'	티브이데일리
소녀시대 유리, 건물주 됐다…논현동 128억원 빌딩 매입	아시아경제
‘1게임 차 초박빙’ 2위 싸움, 누가 유리?	데일리안
주행 중 하늘서 쇳덩어리…차량 유리 박살에도 美운전자 경상 그쳐	부산일보
"정부에 유리한 통계 내려 꼼수" VS "사실 아냐"	대구신문
과학계 '유리천장' 여전…과기평, 관리자급 여성비율 10%대	투데이코리아
국내 최대 돔형 유리온실 '거제 정글돔' 15일 운영 재개	노컷뉴스
갤노트20 탑재 최신 강화 유리에…아이폰12, "받고 다이아 코팅 더"?	뉴스1
유리홀딩스 측 “승리 군사법원 증인과 겹쳐, 분리해달라”	매일경제
“왜 빵빵 거려?” 경적 울렸다고 남의 車 유리 손상	문화일보
잔여경기 많은 두산, 김태형 감독 "유리하지 않을까요"[MD토크]	마이데일리
국세청 '유리천장'…3급이상 여성승진자 2017년 이래 '0명'	파이낸스투데이
태영호 "북, 新무기 공개…미 대선 이후 유리한 고지 선점 의도"	뉴스1
`내집마련` 주담대, 은행 VS 보험사 어디가 더 유리할까?	매일경제
소녀시대 유리, 연예인 건물주 대열 합류···논현동 빌딩 128억원에 매입	서울경제
유리, 앙리할아버지와 나 합류 소식	아시아뉴스통신
유리상자, 1년 반만에 새 싱글 '가을 하늘'	연합뉴스
소녀시대 유리, 건물주 됐다…128억 논현동 빌딩 매입 [엑's 이슈]	엑스포츠뉴스
총경 이상 고위직 경찰 여성 비율 3％…"유리천장 여전"	연합뉴스
국세청의 높은 유리천장…남여 승진 격차 최대 3년↑	스카이데일리
“판은 유리한데, 죄다 ‘올드보이’”…국민의힘, ‘사람 이렇게 없나’ 자조	헤럴드경제언론사 선정
유리, '누가 뭐래도' 타이틀곡 주인공…긍정 에너지 선사	스포츠투데이
‘보는날이 장날’ 이진호 ‘농번기랩’ 능가하는 농민 등장…라이브 커머스 ...	스포츠경향
어디선가 날아든 쇠구슬로 미용실 유리문과 차량 파손…"CCTV에 용의자 흔적 ...	경기일보
유리, '누가 뭐래도' 타이틀곡 주인공…긍정 에너지 선사	스포츠투데이
소녀시대 유리, 128억 강남 건물주 됐다!	여성조선
‘보는날이 장날’ 이진호 ‘농번기랩’ 능가하는 농민 등장…라이브 커머스 ...	스포츠경향
어디선가 날아든 쇠구슬로 미용실 유리문과 차량 파손…"CCTV에 용의자 흔적 ...	경기일보
발수코팅 유지력 높이는 자기회복 자기세정 유리 개발	철강금속신문
코로나19 바이러스, “유리 표면·지폐서 28일간 안 죽는다”	이코노믹리뷰
유리지갑 직장인, 2021년 연봉 인상은 '글쎄'	경북일보
제천 의림지 용추폭포 유리전망대 한국관광공사 '숨은 관광지' 선정	충청매일
소녀시대 유리, 립 제품만 7개 '왓츠 인 마이 백'+실버버튼 언박싱 ('유리한 ...	엑스포츠뉴스
“군사법원 승리와 증인 겹쳐”...法, 유리홀딩스 증인 채택 ‘고심’[종합]	매일경제
“군사법원 승리와 증인 겹쳐”...法, 유리홀딩스 증인 채택 ‘고심’[종합]	매일경제
“사건 유리하게 처리해줄게” 3천만원 뇌물챙긴 경찰 구속송치	KBS
소녀시대 유리, ‘임산물 살리기 프로젝트’로 선한 영향력 행사	스포츠경향
"왜 경적 울려"…안양서 둔기로 차량 유리 파손한 60대 검거	뉴스핌
‘여성이 이런 궂은 일을 해요?’ 유리천장을 부순 ‘라이커스’	서울신문언론사 선정
현대모비스 “차량유리에 내비장치 등 300억 투입”	동아일보
소녀시대 유리, 논현동 빌딩 '128억원'에 매입…연예인 건물주 대열 합류	세계일보
문화재청, 조선왕실 밤잔치에 쓰던 '사각 유리등' 문화상품으로 발매	매일일보
차 유리·안전벨트·카펫까지… 재활용 넘어 패션 제품으로 재탄생	조선일보
성환농협, 국내 최초 '항균·항바이러스 보호 유리' 설치	중앙일보
차 유리·안전벨트·카펫까지… 재활용 넘어 패션 제품으로 재탄생	조선일보
성환농협, 국내 최초 '항균·항바이러스 보호 유리' 설치	중앙일보
기계연, 고체윤활제 이용한 자기세정 유리 개발	테크월드
수원 영통 '망포역 센타프라자' 상가 10월 중 분양예정… YMCA 아기스포츠단 ...	경상일보
유리상자, 3년 만의 신곡 '가을 하늘' 발표	노컷뉴스
소녀시대 유리, 건물주 됐다…‘초역세권+지상 5층’ 논현동 건물 128억 매입	세계일보
조기 직접투표 열기 1500만명 이미 투표 ‘바이든 유리’	라디오코리아
'유리한 식탁' 유리, 임산물 살리기 프로젝트 동참 "종사자분들 힘내세요!"	헤럴드POP
유리가 접힌다? 20만번? 갤폴드 가혹실험 직접 보니	머니투데이언론사 선정
유명순, 유리천장 깨고 국내 첫 민간銀 여성행장 눈앞	서울경제
유리가 접힌다? 20만번? 갤폴드 가혹실험 직접 보니	머니투데이언론사 선정
유명순, 유리천장 깨고 국내 첫 민간銀 여성행장 눈앞	서울경제
한국 車업계, 훌륭한 이웃 많아 주변국보다 유리	서울신문
조선왕실 밤잔치에 쓰던 사각 유리등을 내 방에 둔다	미디어리퍼블릭
소녀시대 유리, 128억 논현동 초역세권 건물주 됐다	MBN
LG이노텍, 1년 만에 고효율 페라이트 소재 개발…TV 슬림화ㆍ차량 경량화 유리	이투데이
‘LG 윙’ 공시지원금 최대 24만원… ‘선택약정할인’ 유리	조선비즈
식품에서 벌레, 유리 나왔는데… HACCP(해썹) 인증 유지	부산일보
美대선 경합지에서 코로나 급증…누구에게 유리할까	뉴스1
소녀시대 유리, 논현동 128억 빌딩 건물주 됐다	조선비즈
소녀시대 유리, 논현동 128억 빌딩 건물주 됐다	조선비즈
[굿모닝 증시]“연말에는 기존 실적주보다 새로운 실적주가 유리”	아시아경제
국내 최대 돔형 유리온실 식물원 ‘거제정글돔’ 15일 재개원	부산일보
소녀시대 유리, 임산물 살리기 프로젝트로 선한 영향력 "힘내세요"	enews24
유리상자 '가을 하늘' 발매…"소소하지만 행복한 힐링송"	뉴시스
한국씨티은행, 첫 여성 민간은행장 예고… "유리천장 깼다"	한국일보
"바이든이 약가 인하하는 트럼프보다 국내 제약사에 유리"	한국경제언론사 선정
자동차 폐기물의 변신 '시트, 안전벨트, 앞유리가 옷, 목걸이로~'	지피코리아
채널A 재판장 입에서 "기자 꼼수"…이철에 유리하게 물었다	중앙일보언론사 선정
도심 상가유리 ‘와장창’…멧돼지가 나타났다	스포츠경향
도심 상가유리 ‘와장창’…멧돼지가 나타났다	스포츠경향
유리상자, 1년 6개월 만에 새 싱글 ‘가을 하늘’ 공개	한국경제TV
[소방청 국감] 서범수 “경력채용 출신, 고위직 승진 0명… 유리천장 존재”	FPN
[판세] 납세자에게 유리한 구법(舊法) 적용 가능한가?	세정일보
'유리천장'깬 유명순…첫 여성 시중은행장 된다	아시아경제
볼호프 강의 유람선 위에서 만난 유리에프 수도원	여성조선
녹아내리는 북극 바다 얼음…하얀 ‘유리 가루’가 특효약 될까	경향신문언론사 선정
[2020 국감] 국토부 산하기관 절반은 여성임원 0명…견고한 '유리천장'	아주경제
'소녀시대' 유리 건물주 됐다…서울 논현동 5층 빌딩 128억 매입	금융소비자뉴스
통신3사, LG ‘윙’ 출시..공시 지원금보다 25% 요금할인이 유리	이데일리
통신3사, LG ‘윙’ 출시..공시 지원금보다 25% 요금할인이 유리	이데일리
1000만 가입자 앞둔 5G…소비자에 유리한 요금제는?	EBN
신혼부부 vs 생애최초, 30대 내 집 마련 어떤 게 유리할까	더팩트언론사 선정
유리상자가 다시 열렸다…3년 만에 새 싱글 ‘가을 하늘’ 발표	문화일보
여전히 유리천장 높은 검찰청‧법무부, 여성 고위공무원 수... 국정과제 목표...	한국무역신문
추석 이후 한도 줄고, 금리 뛰고…"신용대출 빨리 받아야 유리"	한국경제언론사 선정
[더 오래]금·은보다 수정이나 유리구슬 선호한 가야인	중앙일보
중소기업 오래다닌 무주택자, 특별공급 APT '유리'	메트로신문
술 취해 둔기로 차량 유리 내려친 60대 영장	KBS
소녀시대 유리, 논현동 128억 건물 매입	서울이코노미뉴스
소녀시대 유리, 논현동 128억 건물 매입	서울이코노미뉴스
가야시대 유리목걸이 보물된다	문화일보
씨티은행장에 유명순 사실상 확정···은행 유리천장 깨졌다	시사저널이코노미
총경 이상 고위 여성 경찰 비율 3％..."유리 천장 여전"	YTN
식품에서 벌레·유리 나왔는데…HACCP 인증 유지	메디컬투데이
벌레·유리조각·곰팡이...배달음식 이물질 신고 하루 4.2건	중앙일보
'3위 점프' 서울E, 부천에 3-0 완승...PO행 유리한 고지 [오!쎈 현장]	OSEN
이자 높고 예금도 보호…5000만원까진 저축은행이 유리	이데일리
공정위, 퇴직자에 유리한 검토의견 써줘…“감시 강화해야”	KBS
유리상자, 신곡 '가을 하늘'로 컴백…이세준 작사·박승화 작곡	MBC연예
공정위, 퇴직자에 유리한 검토의견 써줘…“감시 강화해야”	KBS
유리상자, 신곡 '가을 하늘'로 컴백…이세준 작사·박승화 작곡	MBC연예
‘청년특별구직지원금’ 2차 신청 오늘(12일) 시작…예산 한정으로 일찍 신청...	디지틀조선일보
민주당 독식이 美 경제에 유리?…월가가 바이든 반기는 이유	이데일리언론사 선정
한국기계연, 오염물질 붙지 못하는 유리 개발…"벌레 잡는 식물 아이디어"	YTN사이언스
1700여 년 전 가야인의 유리 목걸이 보물된다	문화일보
[시그널]빅히트 1주라도 더 받으려면···큰손 'NH·한투', 주린이 '미래에셋...	서울경제언론사 선정
KTX역세권 개발 수혜 기대 高, 여가 생활과 투자 모두 유리한 ‘속초스테이' ...	환경일보
박인비 "내가 쳐 본 골프장 중 가장 길게 느껴져…장타자에게 유리할 듯" [LP...	골프한국
'유리몸' 포르징기스, 오른쪽 무릎 수술 받는다…복귀 시점 미정	스포츠서울
박인비 "내가 쳐 본 골프장 중 가장 길게 느껴져…장타자에게 유리할 듯" [LP...	골프한국
'유리몸' 포르징기스, 오른쪽 무릎 수술 받는다…복귀 시점 미정	스포츠서울
가야 유리 세공 기술 보여주는 목걸이 3점 보물 지정 예고	KBS
유경준 의원 “통계청 가계동향조사 비율 조작” | 유 의원 “(문재인)정부에...	월간조선
[피플앤데이터] 첫 민간여성 은행장…‘유리천장’은 넘었지만	헤럴드경제
공모주 직접 청약보다 펀드가 수익률 유리…빅히트도 통할까	한국경제TV
뒷차 '빵빵' 소리에…둔기 꺼내 차 유리 부순 60대	MBN언론사 선정
구직자 10중 4명 "취업에 유리한 성별 있다"	조선비즈언론사 선정
소시 유리도 강남 건물주 '반열'… 매입 총액이 무려?	머니S
‘뚱보-유리몸-부진’ 아자르, 2년 만에 몸값 1220억원 추락 굴욕	스포탈코리아
"경찰, 총경 이상 고위직 여경 3% 불과...유리천장 여전"	뉴스렙
[2020 국감] 3년째 '남(男)세청'… 국세청 '유리천장' 여전	머니S언론사 선정
메이저 퀸 박인비 "이번엔 장타자에게 정말 유리한 코스"	골프다이제스트
"유리천장 깨겠다"던 지방금융···3년 째 女임원 '전무'	시사저널이코노미
구직자 10명 중 4명 "취업에 유리한 성별 있다"	뉴시스언론사 선정
1700년 전 가야 시대 유리 세공 목걸이 보물된다	파이낸셜뉴스언론사 선정
이통사, LG윙 출시…'짠물 지원금'에 선택약정할인 유리	MTN
[단독]'소녀시대' 유리, 건물주 됐다..논현동 빌딩 128억에 매입	머니투데이
애플 vs 에픽게임스 소송전...아직은 애플에 유리한 구도?	디지털투데이
"유리천장 깬다" 씨티은행 차기 행장 사실상 확정 '유명순 후보'	스페셜경제
한국소비자원, 마스크 등 방역물품 분쟁...판매자 유리하게 조정 지적	BBS NEWS
"트럼프, 코로나19 직접 겪어 바이든보다 유리" 재선캠프	뉴시스
'철의 왕국' 가야의 유리 세공 목걸이 3건 보물 지정	노컷뉴스
"올 수능, n수생에게 정말 유리해?"… 9월 모평 뚜껑 열어보니	머니S언론사 선정
매년 국감 지적에도 공공기관 '유리천장'은 여전	매일노동뉴스
[종합] '굿모닝FM' 유리 "소시 멤버 비혼주의NO, 효연 가장 빨리 결혼할 것 같...	스포츠조선
짠물 지원 ‘LG윙’…선택약정이 더 유리	스페셜경제
돌리는 스마트폰 'LG 윙' 출시…"공시지원금보다 선택약정할인이 유리"	디지털투데이
유리상자, 오늘(5일) '가을 하늘' 발매..1년 6개월만 컴백	스타뉴스
신혼부부 vs 생애최초…3040 청약 어떤 게 유리?	연합뉴스TV언론사 선정
유리상자, 1년 6개월만 새 싱글 '가을하늘' 공개..서정적 가사+하모니	헤럴드POP
취업에 유리한 성별 있다? "남자가 압도적"	파이낸셜뉴스언론사 선정
가야인 유리 목걸이, 보물 된다	부산일보
한국 여성들, 단단한 유리천장 깬다...유명희·유명순 '이름도 비슷'	오피니언뉴스
유리섬유 논란 일산호수공원 인공암 폭포, 친환경 탈바꿈	한국일보
경찰, 총경 이상 고위직 여경 3% 불과.유리천장 여전	위클리오늘
제천시 의림지 '용추폭포 유리전망대' 가을철 '숨은 관광지' 선정	금강일보
‘소시’ 유리 105억 대출 끼고 128억 강남 건물주 됐다	국민일보
[60초 경제] 유리에서 에너지로...삼광글라스, ‘SGC그룹’이 되다	서울경제언론사 선정
달리던 차에 날벼락…의문의 물체 유리 뚫고 승객 머리 강타	동아일보언론사 선정
[60초 경제] 유리에서 에너지로...삼광글라스, ‘SGC그룹’이 되다	서울경제언론사 선정
달리던 차에 날벼락…의문의 물체 유리 뚫고 승객 머리 강타	동아일보언론사 선정
'3급이상 여성 단 1명'…'기본권수호' 헌재 '유리천장' 언제 깨지나	뉴스1
소비자원, 방역 물품 관련 소비자 분쟁 판매자에 유리하게 조정	글로벌경제
소녀시대 유리, 강남 건물주 됐다…논현동 5층 빌딩 128억 매입	오가닉라이프신문
美대선 판세 뒤흔들 진보 대법관의 별세… 누구에게 유리할까	국민일보언론사 선정
유리 바닥 아래는 해안절벽…전망대 끝 그네 타면 바다로 '아찔'	연합뉴스
1700년 전 가야인이 찬 영롱한 유리 목걸이…'철의 왕국' 아닌 '유리의 왕국'...	경향신문
'삼바 전설' 히바우두, '유리몸' 뎀벨레에 독설..."아무것도 증명 못한 선수"	인터풋볼
우정사업본부의 높은 유리천장, 성폭력으로 27명 징계	스카이데일리
[금주의 이슈인] 유명순 한국씨티은행 그룹장 차기 행장 단독후보 올라…"유리...	중부일보
한국씨티은행, 차기은행장 후보로 유명순 단독 추천…유리천장 깬다	월요신문
유리 파편 가득한 울산 주상복합 아파트 주변	뉴스1
유리상자, 오늘(5일) 자작곡 ‘가을 하늘’ 발매 ‘3년만 신곡’	뉴스엔
"올 4분기는 코스닥보다 코스피…수급·실적·밸류에이션 모두 유리"	매일경제
소녀시대 유리, 128억 건물주 됐다…105억 대출받아 논현동 빌딩 매입[종합]	스포티비뉴스
퍼트 부진 날린 토머스, 유리판 그린서 '펄펄'	서울경제
월가 유리천장 깨졌다… 시티그룹 첫 여성 CEO 나와	조선일보언론사 선정
1700년전 가야인 유리 목걸이 보물 된다	디지털타임스
105억 대출로 '갓물주' 된 소녀시대 유리…논현동 빌딩 128억에 매입	뉴스1
지방공기업, 두꺼운 '유리천장' 여전히 심각	시사위크
1700년전 가야 유리 목걸이 3건, 보물 된다	TV조선
"유리인 줄 알았는데…" 美 은행원 9캐럿 다이아몬드 발견	부산일보언론사 선정
'굿모닝FM' 유리 "소녀시대 비혼주의 NO…효연 제일 먼저 갈 것 같아"	엑스포츠뉴스
유리상자, 1년 반만에 새 싱글 '가을 하늘' 발매	MBN
[비즈이슈] 씨티은행장에 유명순 사실상 확정…"유리천장 깼다"	팍스경제TV
유리상자, 1년 6개월 만에 싱글 '가을 하늘' 공개	일간스포츠
국내 1위 건축유리·자동차유리 합친다	헤럴드경제
[국감2020] 역대기관장 94명 모두 남성…높기만 한 우본 유리천장	디지털데일리
ETRI, 작고 고전압에 유리한 수직형 질화갈륨 전력반도체 개발	MTN
KCC글라스, 코리아오토글라스 합병…유리 사업 시너지 높인다	아이뉴스24
유리문 사이로 비접촉 면회	뉴시스
카카오게임즈 공모주 오늘부터 개인 청약… 어느 증권사가 유리할까	조선비즈언론사 선정
조선왕실 밤잔치에 쓰던 '사각 유리등' 문화상품으로 개발	뉴스다임
[앵커의 눈] “공정위, 퇴직자에 유리한 검토 의견 제출”…감시 강화해야	KBS
'철의 왕국' 가야, 유리세공 기술도 으뜸…가야인 유리 목걸이 보물 된다	뉴스1
벨킨, 애플기기 전용 프라이버시 강화유리 출시	에이빙뉴스
경찰, 총경 이상 고위직 여경 3% 불과...유리천장 여전	경인매일
[잠실리뷰]'이틀 연속 초전 박살' 두산, KIA 3연전 스윕…유리한 고지	스포츠조선
‘굿모닝FM’ 유리 “소녀시대 비혼주의 NO, 효연 결혼하고 싶어해”	뉴스엔
‘굿모닝FM’ 유리 “소녀시대 비혼주의 NO, 효연 결혼하고 싶어해”	뉴스엔
1700년 전 가야인이 정교하게 만든 수정·유리목걸이 3건 보물 된다	이데일리
알쏭달쏭 헷갈리는 보험 사례··· 실손보험 중복 가입하면 보험료를 이중 부...	매일경제
카카오게임즈 오늘부터 청약, 유리한 증권사 있나	파이낸셜뉴스언론사 선정
직장인 10명 중 7명 "승진하려면 이직이 유리"	조선비즈언론사 선정
은행 '유리천장' 깨졌다…씨티銀 유명순 직무대행, 차기 은행장 단독 추천	뉴스저널리즘
유리 건물주, 소녀시대→128억 빌딩주됐다…윤아도 100억대 건물 매입	이투데이
`LG윙` `갤럭시S20 FE` 동시 출격…공시지원금 적어 선택약정이 유리	매일경제
5강 향한 실낱같은 희망…윌리엄스 "잔여경기 최다, 유리할 수 있다" [MD토크...	마이데일리
청약보단 공모주펀드가 수익률 유리…빅히트도 통할까	파이낸스투데이
청약보단 공모주펀드가 수익률 유리…빅히트도 통할까	파이낸스투데이
5년간 기재부 4급 이상 女 승진자 단 2명… 유리천장 여전	이데일리
[2020국감] 정부, 국민 주거 수준 유리한 통계만 발표… 오히려 양극화 심화	천지일보
조선 왕실 밤 잔치에 쓰인 사각 유리등 문화 상품 개발	대전시티저널
유리 칸막이 설치된 수보회의	뉴시스
"유리섬유 없다"…고양시, 일산호수공원 자연석 폭포 조성	뉴시스
'굿모닝FM' 유리 "소녀시대, 비혼주의 아냐..효연 가장 먼저 갈 것 같아"	OSEN
"新기후체제 한국에 유리…경제발전 기회 삼아야"	매일경제
갤럭시폴드2, S펜 빠진다…디스플레이는 '초박형유리'	뉴시스언론사 선정
쿨 유리, 미국 LA에서 보낸 추석..한복 입은 아이들 예쁘네	헤럴드POP
쿨 유리, 미국 LA에서 보낸 추석..한복 입은 아이들 예쁘네	헤럴드POP
벨킨, 아이폰·아이패드용 사생활 보호 강화유리 출시	전자신문
'유리지갑' 직장인만 봉? "10년간 고소득자 탈루소득 무려 10조"	한국일보언론사 선정
[테크위크 2020 LIVE]"단단한 유리에 폴딩 기능을"…LPKF 가공 기술 시선	전자신문언론사 선정
삼광글라스 '글라스락 베이비 세이프 유리식기' 출시	파이낸셜뉴스
한국씨티은행 '유리천장' 깨졌다	공감신문
1천700년전 가야인 제작 유리 목걸이 3건, 보물 지정	MBC
포항지진 피해 입증자료 많이 제출 할수록 유리	경상매일신문
[목멱칼럼]유리천장 걷어낸 도산서원	이데일리
인명 구조견 ‘유리’…부산 장산 등산 중 길 잃은 60대 2명 구조	더팩트언론사 선정
'굿모닝FM' 유리 "소녀시대 비혼주의 아냐…효연 결혼하고 싶어해"	뉴스1
삼광글라스, '베이비 유리식기&스낵뚜껑 흡착볼' 출시	이데일리
KCC글라스, 코리아오토글라스 합병.."유리사업 일괄체계 구축"	머니투데이
[프리미엄 리포트]구글 AI에게 물었다…"유리는 고체인가,액체인가"	동아사이언스언론사 선정
카페 드롭탑, 화가 이왈종 유리컵 2종 출시	뉴시스
머리카락 3분의 1 '접히는 유리'…Z폴드2, 형보다 낫네	머니투데이
상처 스스로 회복하는 '자기 세정 유리' 개발	뉴스웍스
70대가 몰던 승용차, 약국 유리문 뚫고 돌진…2명 부상	머니투데이
[2020 국감 이슈] "벌레, 유리 나왔는데"...'해썹 인증' SPC삼립, 1년 동안 무...	뉴스락
'덜덜 떨리는 창문 테이프 붙이려다…' 유리 깨지며 60대 숨져(종합)	연합뉴스언론사 선정
'덜덜 떨리는 창문 테이프 붙이려다…' 유리 깨지며 60대 숨져(종합)	연합뉴스언론사 선정
총경 이상 고위직 경찰 여성 비율 3％…"유리천장 여전히 견고"	매일경제TV
대선 앞두고 달러 강세로 가면…트럼프보다 바이든이 유리?	중앙일보
[롤드컵] '쇼메이커' 허수, "중후반 유리해서 천천히 하자고 했다"	포모스
“당원투표 않고 의원총회서 선출”…스가, 총리 유리해져	동아일보언론사 선정
“결혼? 당장 내일이라도 할 멤버 있어”…소녀시대 유리의 폭탄 발언	위키트리
[상생협력] 동일유리, 첨단 에너지 절감기술 집약 새 브랜드 런칭	머니투데이
KCC글라스·코리아오토글라스 합병…"유리업계 경쟁력 강화"	에너지경제
'구슬 지름 6㎜' 유리 세공도 뛰어났던 '철의 왕국' 가야	한국일보
與는 "월북" 野는 "시신훼손"…유리한 첩보만 내세우는 여야	중앙일보언론사 선정
[그래픽뉴스] 3급이상 여성 단 1명, 헌재 '유리천장' 언제 깨지나	뉴스1
소녀시대 유리 "'굿모닝FM' DJ 장성규 팬, 안좋은 일 있을 때 같이 시무룩해져...	OSEN
[조국·정경심 재판 LIVE ⑳] 정경심에 유리하던 흐름‥검찰 반격으로 혼전	MBC언론사 선정
영유아용 글라스락 베이비세이프, 유리식기·흡착볼 출시	머니투데이
트럼프, 분쟁 염두뒀나…"의회가 당선자 결정시 내가 유리"	연합뉴스
'유리한 판' 만든 김종인… 文 회동 일단 '유보'	머니투데이언론사 선정
KCC글라스, 주거용 비강화 더블로이유리 출시	뉴시스
씨티그룹, 美 주요은행 중 최초로 여성 CEO 발탁…'유리천장 깼다'	조선비즈언론사 선정
[TF초점] '최초' 女 국회부의장 탄생하나…'유리천장 깨기' 다음은?	더팩트언론사 선정
"나도 주식 시작?"…어느 증권사 유리할까	뉴시스
"나도 주식 시작?"…어느 증권사 유리할까	뉴시스
정보통신기술 기업 여성 팀장 72％ "유리천장 있다"	연합뉴스
'패트 재판'서 언급된 FTA 국회 충돌 판례…누가 유리할까	연합뉴스
홍남기 "부동산 유리한 통계만 제시 아냐…이중삼중 분석 검증"	이데일리언론사 선정
수능 전 마지막 모의평가 응시 재수생들 "고3이 더 유리할 것"	연합뉴스언론사 선정
페이스북, 트럼프 대통령에 유리한 댓글 게재한 '가짜 계정' 276개 삭제	한국일보
제천시 의림지 ‘용추폭포 유리전망대’ 가을철 ‘숨은 관광지’ 선정!	아시아뉴스통신
"유리가 그림이 되네"…투명 OLED로 '미디어 아트' 장식	TV조선
'구미호뎐' 제작진 "사람을 홀리는 이랑과 사람을 노리는 유리의 활약 기대 부...	헤럴드POP
베란다 테이프 작업하던 60대…태풍에 유리 깨져 사망	한국경제TV언론사 선정
1600여년 전 가야 귀족의 ‘명품’ 유리 목걸이, 국가 보물 된다	한겨레
창에 테이프 붙이려다 유리 깨져 60대 출혈사…공포의 마이삭	중앙일보언론사 선정
[기자24시] 금수저 백수에게 유리한 청년주택	매일경제
돌리는 `LG 윙` 싸게 사려면…"약정할인이 54만원 유리"	매일경제
KCC글라스, 주거용 비강화 더블로이유리 출시	한국경제
봉산문화회관 유리상자 '최성임-강을 건너는 방법'전	매일신문
문화재청, 가야 목걸이 3점 보물 지정… 1700년 전 유리세공 기술 보여줘	동아일보
“구직자 10명 중 4명, 취업에 유리한 성별 있다”	에듀동아
KCC글라스-코리아오토글라스 합병… 유리사업자 기반 확대	뉴데일리
기재부 유리천장 타파 역부족…5년간 승진 女 고공원 단 2명	아시아경제
기재부 유리천장 타파 역부족…5년간 승진 女 고공원 단 2명	아시아경제
쿨 유리, 애교 터지는 귀요미 자녀+훈남 남편과 LA에서	헤럴드POP
트위치티비(TV) 유리조아, 상큼 팡팡 터지는 미소...'깜찍뽀짝'	뉴스컬처
유리조각 아수라장 비 맞으며 청소한 ‘포항 천사’ 9명, 장학금 받는다	조선일보언론사 선정
'유리한 식탁' 소녀시대 출격…유리 "콘서트보다 힘들어"	일간스포츠
"유리지갑과 대비돼"…고소득사업자 세금 탈루액 10년간 10조	중앙일보
美 ITC 배터리 판결 연기, LG-SK 분쟁에 새 변수...재계 "끝장 싸움은 중국만...	조선비즈언론사 선정
[초점] 북한 열병식 ‘유리한 해석’	글로벌이코노믹
1700년 전 가야 수정·유리 목걸이 3점 보물 지정 예고	서울신문언론사 선정
신혼부부·생애최초 소득기준 더 완화…이사하면 당첨 더 유리?	SBS CNBC
트럼프 또 '불복 시나리오' 언급... "의회가 당선자 결정시 내가 유리"	한국일보언론사 선정
美월가 '유리천장' 깨졌다... 씨티그룹 첫 여성 CEO 탄생	한국일보언론사 선정
락앤락, 새 유리밀폐용기 '탑클라스' 출시	이데일리
맨유 '유리몸' 바이 또 다쳤다... 대표팀 경기 중 햄스트링 통증	스타뉴스
인피크래프트, 내달부터 캐스터스 항균보호 유리 수입 판매	연합뉴스
소녀시대 유리, 사연 있는 '쿡방' 도전	노컷뉴스
유리천장 깬 사법연수원 19기 女법조인 3인 ‘주목’	세계일보
삼광글라스 글라스락 베이비 유리식기·스낵뚜껑 흡착볼 출시	EBN
카페 드롭탑, 화가 이왈종과 콜라보.."유리컵 2종 출시"	파이낸셜뉴스
카드론 유리한 곳은…고신용자 '우리', 저신용자 'DGB대구은행'	아시아경제언론사 선정
카페 드롭탑, 화가 이왈종과 콜라보.."유리컵 2종 출시"	파이낸셜뉴스
카드론 유리한 곳은…고신용자 '우리', 저신용자 'DGB대구은행'	아시아경제언론사 선정
우병우, 경향신문 상대 정정보도 승소… 조국에도 유리한 판결	아시아경제언론사 선정
러시아 유리 밀폐용기 시장동향	KOTRA해외시장뉴스
[2020국감] 유리천장 높은 축산물품질평가원…간부 중 여성직원 '0명'	뉴스핌
[황정아의 우주적 시선] 노벨상의 유리천장을 깬 여성과학자들	한국일보
[줌인 이종목] 강화유리 강자 제이앤티씨 주가 `쑥`	매일경제
'1억에 5주' 슈퍼개미만 유리한 청약제도 개편되나	노컷뉴스언론사 선정
"훔쳐봐도 소용없다"…벨킨, 아이폰·패드 프라이버시 유리 출시	머니투데이
가야 귀족 '유리목걸이' 보물감이네	경남일보
열처리 없이도 뛰어난 단열 'KCC 더블로이유리'	서울경제
인터넷가입 및 티비(TV)결합상품 현금지원 사은품많이주는곳, 비교사이트가 유...	CCTV뉴스
'보수 대법관 지명' 배럿의 긴즈버그 극찬…"유리천장 부쉈다"	연합뉴스
옥주현X이진, 핑클 막내 성유리 향한 애정···송혜교 "애기애기한 유리"	일간스포츠
"트럼프 정치적 이미지 실추...美대선 바이든 유리"-한투	에너지경제
"기업규제3법, 외인 투자가에 유리한 판 만들어 주는 꼴"	서울경제언론사 선정
건물유리 와장창!…공포 가시기도 전에 더 센 '하이선' 온다	머니투데이언론사 선정
홍남기 "부동산대책 성과 나타나"…'유리한 통계만 제시' 해명	아시아경제언론사 선정
‘굿모닝FM’ 유리 “요리, 신부수업 절대 아냐…손맛 자부심 있다”	뉴스엔
[속보] '마이삭 강타' 부산서 깨진 베란다 유리에 60대 출혈사	한국경제언론사 선정
“주거안정에 월세가 유리할 수도” 조기숙 페북 글[전문]	국민일보언론사 선정
권유리(소녀시대 유리), 웹예능 ‘유리한 식탁’으로 입증한 예능감+요리 실력	한국경제TV
소녀시대 태연·윤아·유리·효연·써니, SM과 재계약 (공식)	YTN
美 ITC 최종판결 일정 3주 연기, 누구에게 더 유리할까?	오토데일리
검찰 "이재용, 유리한 합병 위해 불법 행위 조직적 자행"	YTN
KCC글라스, 주거용 비강화 더블로이유리 출시	매일경제
옆 사람 시선 차단…벨킨, 애플용 사생활 보호 강화유리 출시	아시아경제
소녀시대 유리, 로맨스물 '이별유예, 일주일' 주인공 캐스팅	텐아시아
바이든 잡던 해리스, 또 한번 유리천장 깨고 러닝메이트로	연합뉴스
트럼프 "의회가 당선자 결정하는 상황 오면 내가 유리"	한국경제
트럼프 "의회가 당선자 결정하는 상황 오면 내가 유리"	한국경제
국회의장·주요 상임위장…여전한 ‘유리천장’	경향신문언론사 선정
쿨 유리, 삼남매와 즐거운 LA 생활 "먹고 놀고"	매일경제
삼성, 유리처럼 ‘투명한 폰’ 개발…상용화는 언제?	데일리안언론사 선정
냉장고에 깔리고 베란다 유리 깨져 출혈사...부산 할퀸 '마이삭'	이데일리언론사 선정
[2020 온라인 공공기관 채용설명회(8)] 영어 실력자가 유리한 한국과학기술원...	뉴스투데이
구하러 왔더니…만취한 10대, 구급차 발로 차고 유리 박살	중앙일보언론사 선정
'승격로드' 이분화, 잔여일정 유리한 팀은? [K리그2 순위]	스포츠Q
KCC글라스, 단열 효과 높인 '주거용 비강화 더블로이유리' 출시	뉴스1
퇴직연금, 호봉제 근로자는 ‘DB형’이 더 유리	농민신문
씨티그룹, 첫 여성 CEO 발탁…'유리천장' 깨졌다	한국경제
홍준표 文 향해 "유리할 땐 내가 했고, 불리하면 비서관인가"	서울경제언론사 선정
문체부 고위 공무원단 25명 모두 남성...최형두 의원 "공무원 유리천장 심화"	CNB뉴스
소녀시대 유리 "휴식기 동안 요리 배워…신부수업? 절대 아냐" ('굿모닝FM')	마이데일리
'유리한식탁' 오상진 등장, 유리와 의외 인맥 남매 케미	스포츠조선
與 토론회서 나온 '조 바이든 치매설'…"트럼프가 압도적 유리"	조선비즈언론사 선정
권유리(소녀시대 유리), 미니드라마 ‘이별유예, 일주일’ 주연 확정	한국경제TV
"女 기관장 1명도 없는 우정사업본부, 성폭력 사건으로 27명 징계"...유리천장...	오늘경제
'얼음정수기' 특허소송전 6년…청호나이스, 유리한 고지 올라	한국경제
트럼프 "이번 대선 재앙될지도…의회가 결정하면 내가 유리"	한국경제TV
[자막뉴스] 책상에 올려둔 강화유리...난데없이 폭발	YTN언론사 선정
'검블유'는 환상?…정보통신 분야 女 팀장 72% "유리천장 있어"	뉴시스
유리 캐스팅, ‘이별유예’ 주연 발탁…오늘(28일) 첫 촬영 진행 (공식)	MBN
'유리천장 깨졌다'…씨티그룹, 월가 대형은행 첫 여성 CEO 발탁(종합)	연합뉴스
"전월세 갱신 때, 집주인이 더 유리해진다?"…정부의 황당한 해명	디지털타임스언론사 선정
야당 “문 대통령, 참 구차해…유리할 땐 내가, 불리하면 비서관이”	문화일보언론사 선정
트럼프, 대선 불복 시나리오 2탄 제시…“의회가 당선자 결정시 내가 유리”	경향신문
소녀시대 유리 "장성규, 성대결절 올까 봐 걱정된다" ('굿모닝FM')	마이데일리
'유리한 식탁' 권유리, 요리 실력+예능감 입증..매력만점 재능부자	헤럴드POP
가야 유리 목걸이, 보물 된다	조선일보
가야 유리 목걸이, 보물 된다	조선일보
가야인이 금‧은보다 가치 둔 ‘유리‧수정’ 목걸이 보물 된다	아이뉴스24
소녀시대 태연·윤아·유리·효연·써니, SM과 재계약 체결 [공식]	한국경제
김두관 “지자체장 집무실 침대 없애고 투명유리 설치하자”	경향신문언론사 선정
‘성장통’ 김윤수 향한 허삼영 감독의 조언 “유리한 카운트 잡아라” [엠스...	엠스플뉴스
'변론종결' 유인석 불참..버닝썬·유리홀딩스 재판ing[종합]	스타뉴스
식품에서 벌레, 유리 나왔는데 HACCP(해썹) 인증 유지... 롯데제과 SPC 오리온...	한국면세뉴스
직장인 67% "승진하려면 이직이 유리"	뉴시스
기재부, 유리천장 여전…5년간 승진한 고위 女공무원 단 2명	스카이데일리
카페 드롭탑, 이왈종 유리컵 2종 출시	뉴스워커
카페 드롭탑, 이왈종 유리컵 2종 출시	뉴스워커
양성평등 시대라지만, 여성직장인 64% “여전히 유리천장 존재”	조선일보
이원다이애그노믹스, 세포유리DNA 분석기술 특허 3건 등록	전자신문언론사 선정
'유리한 식탁' 오상진, 의외의 허당미...유리와 현실남매 케미	스포츠조선
소시 유리, 뛰어난 예능감X요리실력 '재능부자'	enews24
직장인 67%, 승진하려면 ‘이직’이 유리하다	에듀동아
文 부동산 때렸던 조기숙 "주거안정에 월세가 유리할 수도"	중앙일보언론사 선정
"조은희 재산세 감면안, 부자동네만 유리" 與시의원의 질타	중앙일보
쿨 유리, '최고 45도' LA서 여유로운 집콕 생활	아시아경제
1700년 전 가야인 유리목걸이 3점 보물 된다	국제신문
김해가야고분 출토 1700년전 유리 목걸이 3점, 보물된다	데일리한국
테슬라, '품질논란' 이번에는 주행 중 날아간 `유리지붕`	지피코리아
‘유리한 식탁’ 소녀시대 출연…유리 “콘서트 3시간 보다 힘들다” 하소연	스포츠동아
[굿모닝 증시]“증시 상승 탄력 둔화 대비한 배당성장주 투자 유리 국면”	아시아경제언론사 선정
유리홀딩스 전 대표, 첫 재판서 혐의 인정…승리는 군사재판	동아일보언론사 선정
KCC글라스, 자동차용 안전유리 생산 코리아오토글라스 합병	민주신문
벨킨, 애플 기기 전용 '스크린포스 프라이버시 강화유리' 공개	씨넷코리아
유리, 꽃보다 화사한 미모 '끝판왕 비주얼'	enews24
권유리, '유리한 식탁'으로 입증한 예능감+요리 실력 '재능 부자'	엑스포츠뉴스
강풍에 창문 테이프 붙이려다… 유리 깨지며 60대 숨져	문화일보
달리는 옆차 앞유리에 '밀크티' 부어버린 中 운전자	서울경제언론사 선정
'월가 악녀'에서 첫 여성 CEO까지..월스트리트 유리천장 100년	중앙일보
쿨 유리, 남편과 달달한 데이트..미국 LA 이민 후 잘 살고 있네	헤럴드POP
태풍에 창문 테이프 작업 하던 60대, 유리 깨져 사망	TV조선언론사 선정
[영상] 벽돌로 '퍽' 하자 유리문에 구멍이…영업중단 PC방 턴 절도범	연합뉴스
지방흡입 재수술, 기존 절개창 vs 新절개창 유리한 것은?	보건뉴스
유리 쿡방 '유리한 식탁' 첫 공개…숨겨둔 요리실력 전격 공개	한국경제
골프, 유리몸, 그리고 손흥민…토트넘행 임박한 베일의 모든것	국민일보
유리사업 일괄 체계 구축... KCC글라스, 코리아오토글라스 합병	Korea IT Times
[영상] '순간적으로 욱해서'…달리는 차 앞유리에 음료 뿌리고 뺑소니	연합뉴스
유리사업 일괄 체계 구축... KCC글라스, 코리아오토글라스 합병	Korea IT Times
[영상] '순간적으로 욱해서'…달리는 차 앞유리에 음료 뿌리고 뺑소니	연합뉴스
털 말리는 건조기…강아지 나오려다 유리 깨져 큰 사고	JTBC언론사 선정
옥주현X성유리X이진, 꽃미모 자랑→송혜교 “유리는 아직도 애기”	매일경제
소녀시대 유리, 서정적 드라마 '이별유예, 일주일' 주연 확정	SBS funE
2m 높이서 떨어뜨려도 '멀쩡'…코닝 유리소재 갤노트20 탑재	한국경제
KCC글라스, 유리 이맥스 클럽 확대…"품질 관리 강화"	뉴시스
구직자 44.8% "취업에 유리한 성별 있다"…"남성이 유리" 84.3%	뉴스1
소녀시대 태연·윤아·유리·효연·써니, SM과 재계약 "적극 지원"	뉴스1
트럼프·바이든, 누가 당선돼야 삼성에 유리할까?	한국경제언론사 선정
벨킨, 애플기기 전용 사생활 보호 강화유리 선봬	이데일리
KCC글라스, 주거용 비강화 더블로이유리 출시	주간한국
페트·유리 버릴 땐 이렇게…분리배출표시 도안 개선	뉴스1
소녀시대 유리, '유리한 식탁' 통해 멀티매력 과시	RPM9
1천700년 전 가야인이 만든 유리 목걸이 3건, 보물 된다	연합뉴스
“대입전형 아무리 바뀌어도 상위계층 유리”	경향신문언론사 선정
(이슈분석)건설업계의 통합발주 유리하다는 주장 과연 근거 있나	전기신문
소녀시대 태연·윤아·유리·효연·써니, SM 재계약	더팩트
'1박2일 4', 김선호 유리심장 인증→라비 '배신의 아이콘' 등극	뉴스1
“내부 훤히 보여”…도쿄 번화가에 설치된 ‘투명 유리’ 화장실	동아일보언론사 선정
'1박2일 4', 김선호 유리심장 인증→라비 '배신의 아이콘' 등극	뉴스1
“내부 훤히 보여”…도쿄 번화가에 설치된 ‘투명 유리’ 화장실	동아일보언론사 선정
카페 드롭탑, 이왈종 유리컵 2종 출시	이코노뉴스
여성팀장 72% "유리천장 존재"…여성 임원 확대하려면?	뉴스1
주택담보대출 1%대, 어떤 대출상품이 유리할까?	한겨레언론사 선정
KCC글라스, 주거용 비강화 더블로이유리 출시	국토일보
유리, 꽃다발 앞에서도 기죽지 않는 화려한 미모..사랑스러움 甲	헤럴드POP
코픽스, 잔액기준 대출금리 6bp 하락…기존대출자 유리	조세일보
벨킨, 애플 기기 전용 프라이버시 강화유리 대거 공개	마켓뉴스
구직자들 "취업시 남성이 여성보다 5.3배 유리"	머니투데이
벨킨, 애플 기기 전용 프라이버시 강화유리 대거 공개	마켓뉴스
구직자들 "취업시 남성이 여성보다 5.3배 유리"	머니투데이
홍남기 “반포자이 4억 하락”…정부, 유리한 통계만 언급	SBS CNBC언론사 선정
유리 캐스팅, 미니드라마 ‘이별유예, 일주일’ 주연 확정[공식]	매일경제
"반포자이 집값 4억 떨어졌다"…"유리한 통계만 짜깁기"	한국경제언론사 선정
유리, 이소라 주스 맛보고 당황…"누가 주스를 맛으로 먹니"	뉴시스
월가의 가장 견고한 '유리 천장' 깨졌다…美 대형은행 첫 여성 CEO	한국경제
[사이언스프리즘] 유리는 고체일까, 액체일까	세계일보
올해 수능은 재수생이 유리? 교육당국 “난이도 조정 이유 없다”	한겨레언론사 선정
KCC글라스, 단열성 업그레이드 '더블로이 유리' 출시	EBN
[공식]소녀시대 유리, 미니드라마 ‘이별유예, 일주일’ 주인공 확정 "애틋 로...	스포츠조선
KCC글라스, 단열성 업그레이드 '더블로이 유리' 출시	EBN
락앤락, 유리 밀폐용기 기준 높인 ‘탑클라스’ 출시	아시아경제
달리는차 유리에 커피 끼얹었다···'살인미수' 뺨친 中보복운전 (영상)	중앙일보언론사 선정
소녀시대 써니·태연·윤아·유리·효연, SM과 재계약 [공식]	이데일리
유일호 전 부총리 "기업규제3법, 외인 투자가에 유리한 판 만들어 주는 꼴"	서울경제언론사 선정
유리 쿡방 오픈, 첫 선 보일 레시피는?	디지털타임스
유리 칸막이 설치된 수석·보좌관 회의실	연합뉴스
中 매체들 트럼프 확진 앞다퉈 보도…대선에 유리할 수도	아시아경제
KB노협 "회장 추천 방식, 현 회장에 유리"...사측 "절차 공정"	한국경제
유리 칸막이 설치된 수석·보좌관 회의실	연합뉴스
中 매체들 트럼프 확진 앞다퉈 보도…대선에 유리할 수도	아시아경제
소녀시대 유리, 유튜브 ‘쿡방’ 도전한다	스포츠경향
KB노협 "회장 추천 방식, 현 회장에 유리"...사측 "절차 공정"	한국경제
KCC글라스, 유리 가공 전문 네트워크 강화	서울경제
서울 구로구에서 건물 15층 외벽 유리 '와장창'…1명 부상	연합뉴스
기시다 정조회장, '포스트 스가' 경쟁 유리한 고지 선점	노컷뉴스
KCC글라스, 주거용 비강화 더블로이유리 신제품 출시	데일리한국
월가 '유리천장' 깨졌다…씨티그룹 차기 CEO에 프레이저	이데일리
소녀시대 태연·윤아·유리·효연·써니 5人, SM과 재계약 [공식]	텐아시아
KCC글라스, 주거용 비강화 더블로이유리 신제품 출시	데일리한국
월가 '유리천장' 깨졌다…씨티그룹 차기 CEO에 프레이저	이데일리
소녀시대 태연·윤아·유리·효연·써니 5人, SM과 재계약 [공식]	텐아시아
카드론 표준등급 공시 한 달…고신용자, IBK기은 카드론 유리	아시아경제언론사 선정
씨티그룹, 미 주요은행 사상 첫 여성 CEO 발탁…'유리천장 깼다'	연합뉴스
유리 칸막이 설치된 수보회의	뉴시스
조국 "형소법 148조" 반복…정경심에겐 유리할까 불리할까	머니투데이
[금일 정치권 주요기사] 판세는 유리한데 인물 없는 野...이재명 "가덕도 신공...	청년일보
금융권 여성 임원 평균 5%… 여성 비중 늘어도 '유리천장' 여전	여성신문언론사 선정
슈피겐코리아, 테슬라 모델3 전용 강화유리 선보여	스포츠조선
조국 "형소법 148조" 반복…정경심에겐 유리할까 불리할까	머니투데이
[금일 정치권 주요기사] 판세는 유리한데 인물 없는 野...이재명 "가덕도 신공...	청년일보
금융권 여성 임원 평균 5%… 여성 비중 늘어도 '유리천장' 여전	여성신문언론사 선정
슈피겐코리아, 테슬라 모델3 전용 강화유리 선보여	스포츠조선
검찰 '그대로 기소' 가능성…삼성 '유리한 고지' 선점	MBC언론사 선정
구직자 10중 4명…"취업에 유리한 성별 있다…여성보단 남성"	여성신문
서울 구로구 15층 빌딩 꼭대기층 유리 깨져…1명 부상	KBS
‘탄도미사일 사거리 연장’이 한국에 유리하기만 한 걸까	한겨레언론사 선정
[그렇구나! 생생과학] 방탄유리는 포탄도 막을 수 있을까	한국일보언론사 선정
한국의 '워런 버핏' 존리 "지금은 월세가 유리"…'돈벌래'	뉴시스
유리, 블랙 시스루 원피스로 '섹시+러블리' 미모 동시에 "만두...널 갖겠어"	스포츠조선
‘유리천장’ 뚫은 해리스 “비극을 무기로 삼는 대통령 끝내야”	문화일보
‘원컴 방송’용 PC, 인텔 10세대 CPU가 유리한 이유는?	IT조선
슈피겐코리아, 테슬라 모델3 전용 강화유리 출시	전자신문
여성 고위공무원 비중 7.9%…"여전히 유리천장"	한국경제
고소득일수록 근로자보다 '자영자'가 세부담에서 '유리'하다	세정일보
태연X윤아X유리X효연X써니, SM과 재계약…의리의 소녀시대 (공식입장)	MBN
‘유리한 식탁’ 유리 분식 메뉴 정식 출시…레시피 기대↑	스포츠동아
삼광글라스, 글라스락 베이비 세이프 유리식기 등 출시	파이낸셜뉴스
‘유리한 식탁’ 유리 긴장하게 만든 특급 카메오 누구?	스포츠동아
책상이 갑자기 '펑'…강화유리 책상 폭발	MBN
소녀시대 유리, 예능감+요리실력으로 브라운관 넘어 웹예능까지 완벽 접수	bnt뉴스
소녀시대 유리·AOA찬미, '댕댕아 모하냥' 오늘 공개	뉴시스
부산서 강풍에 베란다 유리 깨지며 60대 과다출혈사	연합뉴스언론사 선정
”시간 지날수록 경영계에 유리”…최저임금 공익위원, 동결 선택하나	조선비즈언론사 선정
1천700년전 가야인이 만든 영롱한 유리 목걸이 3건, 보물 된다	연합뉴스
유리, 절친 효민과 '쿡방'...청어 소바 만들기 도전	뉴시스
유리천장 또 깼다… 해리스, 美 첫 흑인여성 부통령 후보 낙점	세계일보언론사 선정
쿨 유리, 마스크로 가려도 힙함은 그대로…명품백은 거들 뿐	헤럴드POP
4대강 공방 … 누구에게 유리할까	내일신문
감독의 유쾌한 예감, "DH 낮경기, 양현종에게 유리할 것"	스포티비뉴스
허영지, 초록 가득 유리 온실 공개…'나의 판타집' 최고 1분	뉴시스
1차전 앞둔 김광현의 자신감 "SD 상대로 유리한 점 있어"	엠스플뉴스
소녀시대 윤아·태연·유리·써니·효연, SM과 재계약[공식]	매일경제
삼광글라스, ‘베이비 세이프 유리식기·스낵뚜껑 흡착볼’ 출시	뉴스토마토
직장인 여성 10명 중 7명 "회사 내 유리천장 여전히 존재한다"	이데일리
'편스토랑' 소녀시대 유리X효연, 절친 전혜빈 집 방문…'요리실력 공개'	한국경제
소녀시대 유리, 리얼 쿡방 도전! 유튜브 '유리한 식탁' 오픈	MBC연예
'동상이몽2' 전진♥류이서, 껌딱지 신혼 생활 공개…김재우X조유리 셀프뮤비 ...	헤럴드POP
“베이루트 폭발 한국인 인명 피해 접수 안돼”…한국 대사관도 유리 파손	세계일보언론사 선정
코닝, 강화유리 '고릴라 글라스 빅터스' 발표... 삼성 신제품에 첫 적용	조선비즈
'유리한 식탁' 찐친 수영, 추억 폭격기 활약 "유리 잡으러 왔다"	스포츠조선
소녀시대 유리, '이별유예, 일주일' 주연 캐스팅…오늘(28일) 첫 촬영	브릿지경제
유리천장 깨고 헌정사 첫 여성 국회부의장된 김상희	연합뉴스언론사 선정
문화재청, 1,700년 전 '가야의 유리 세공 목걸이' 3건 보물 지정	뉴스다임
방파제 무너지고 상가 유리 '와장창'…곳곳 정전 피해도	TV조선
티파니 "LA 식성→채식 관심"…웹예능 '유리한 식당'	뉴시스
KCC글라스, 에너지 성능 개선한 주거용 ‘더블로이유리’ 출시	에너지경제
와장창 깨진 엘리베이터 유리 외벽	뉴스1
얼음정수기 6년 특허 전쟁…청호나이스 '유리한 고지'	한국경제
태풍 할퀴고 간 부산…깨진 유리 정리하다 60대 출혈사	SBS언론사 선정
“최성해, 한국당 눈치 봤다” 증언에 檢 “조국 편 드는 게 유리”	국민일보언론사 선정
SM 측 “소녀시대 태연·윤아·유리·효연·써니 재계약”(공식입장)	MK스포츠
"창틀 두께↓ 유리면적↑"…KCC 주방전용 시스템 창호 선봬	뉴스1
KCC글라스, 주거용 비강화 더블로이유리 출시	건설타임즈
서울 구로구에서 건물 15층 외벽 유리 '와장창'…1명 부상	SBS
고속도로서 날벼락…앞유리 깨고 날아든 물체에 동승자 중상	서울신문언론사 선정
유리 쿡방, 오늘(17일) ‘유리한 식탁’으로 다채로운 레시피 공유	MBN
쿨 유리, 귀요미 세 자녀들과 으리으리한 미국 집콕 일상.."먹고 놀고"	헤럴드POP
“최첨단 유리온실서 삽 대신 컴퓨터 들고 토마토 키워요”	동아일보
“최첨단 유리온실서 삽 대신 컴퓨터 들고 토마토 키워요”	동아일보
[공식] 소녀시대 유리, 미니드라마 '이별유예, 일주일' 주인공 캐스팅	마이데일리
'13주년' 소녀시대, '유리한 식탁' 출격…유리 "콘서트 3시간보다 더 힘들어"	엑스포츠뉴스
'유리한 식탁', 원더걸스 혜림 등장…"이 조합 환영"	뉴시스
소녀시대 태연·윤아·유리·효연·써니, SM 재계약 확정[공식]	머니투데이
베이루트 폭발 : 유리, 알루미늄 수요 폭증	뉴스타운
'편스토랑' 유리X효연, 절친 전혜빈 집 방문 '소녀시대 요리실력 大공개'	스포츠조선
소시 유리 측 "`보쌈-운명을 훔치다` 출연 검토 중"[공식]	매일경제
닦을 유리만 4만2,000장...123층 롯데월드타워 고공 청소 개시	서울경제언론사 선정
우주정거장서도 ‘흑인 유리천장’ 깨졌다	동아일보
'1박2일4' 문세윤X김선호, 유리 심장 주인공은 누구?…역대급 폭로전	스포츠조선
구직자 10명 중 4명, 취업에 유리한 성별 있다	로이슈
‘편스토랑’ 소녀시대 유리·효연, 절친 전혜빈 집 방문…요리실력 공개	스포츠동아
KCC글라스, ‘품질 우선주의’ 유리 이맥스 클럽 확대	이데일리
[스포츠 돋보기]왼손잡이가 절대적으로 유리한 종목은	주간경향언론사 선정
소녀시대 태연·윤아·유리·효연·써니, SM엔터와 재계약	브릿지경제
홍남기 "8·4 대책 성과 있다"…또 유리한 자료만 제시 '논란'	TV조선언론사 선정
신용 괜찮으면 IBK기은 카드론이 유리…저신용은 DGB대구은행	연합뉴스
“임원 절반이 여성”...유리천장 깨 표창받은 한세실업	서울경제
홍남기 “반포자이 집값 4억 하락” 진실은 '또 유리한 통계만'	서울경제언론사 선정
우주의 유리천장도 깨졌다… 첫 흑인 여성 우주정거장 승무원 탄생	어린이동아
“이게 유리라고?”…20만번 접히는 삼성디스플레이 폴더블 OLED	아주경제
슈피겐코리아, 테슬라 모델3 디스플레이 부착용 강화유리 출시	ZDNet Korea
한글라스, 리모델링 시장 코팅유리 공급 확대	EBN
[단독] 윤아·태연·유리·써니·효연, 소녀시대 5人 SM과 재계약	엑스포츠뉴스
김용근 경총 부회장 "정부여당, 노조에게만 유리한 법개정 추진"	이데일리
“경력자에 유리한 수시채용 늘어”… 취준생엔 더 좁아진 취업문	동아일보언론사 선정
은성수 "고액자산가 유리한 공모주 배정 방식 개선할 것"	머니투데이
'친아베계 후보' 유리하게?…새 총리 선출방식 논란	JTBC언론사 선정
갤럭시노트20, 지금보다 2배 튼튼한 전면 '강화유리'로 무장한다	뉴스1
갤럭시노트20, 지금보다 2배 튼튼한 전면 '강화유리'로 무장한다	뉴스1
[영월]최첨단 고추 건조 유리온실 농가 소득 견인	강원일보
비 오는데 길에서 유리 파편 치운 고등학생들 [영상]	국민일보언론사 선정
자연이 만든 유리 보석으로 환경문화운동 리부팅	전북도민일보
소녀시대 태연·윤아·유리·효연·써니, SM과 재계약 [공식]	스포츠경향
옥주현X성유리X이진, 러블리 우정ing..송혜교 "유리는 아직도 애기애기"	스타뉴스
카페 드롭탑, 이왈종 유리컵 2종 출시	로이슈
'1박2일 4' 김선호, 파격 시스루 바지+유리 심장 등극...특산물 사수 대작전 ...	스포츠조선
카카오게임즈 오늘부터 공모주 청약…유리한 증권사는?	컨슈머타임스
‘편스토랑’ 소녀시대 유리-효연, 절친 전혜빈 집 방문 ‘요리실력 공개’	한국경제TV
유리천장 깨며 다져온 전투력…해리스, 트럼프도 몰아붙일까	한겨레
"교도소 보내달라" 경찰 관서 유리문 돌로 친 50대 입건	뉴시스
소녀시대 유리, 안방극장으로 복귀…미니드라마 ‘이별유예, 일주일’ 캐스팅	세계일보
"소녀시대X원더걸스 만남"…혜림, '유리한 식탁' 출격	일간스포츠
소녀시대 유리, 만두 들고 비장한 눈빛 "널 갖겠어"	한국일보
'나의 판타집' 허영지, 로망 속 유리온실 집...4.2%로 출발	YTN
소녀시대 태연·윤아·유리·효연·써니, SM과 재계약	뉴시스
군남댐 방류 버티지 못하고 파손된 유리 가림막	연합뉴스
비오는데도 거리 유리파편 청소 세명고 학생에게 장학금	뉴시스
소녀시대 태연·윤아·유리·효연·써니 5人, SM과 재계약…13년 의리 이어간...	스포츠조선
비오는데도 거리 유리파편 청소 세명고 학생에게 장학금	뉴시스
소녀시대 태연·윤아·유리·효연·써니 5人, SM과 재계약…13년 의리 이어간...	스포츠조선
세균잡는 멸균유리, 음압병동에 적용된다	아시아경제언론사 선정
미래차에서 중요해진 핵심 구조물 '유리'	미디어펜
소녀시대 태연·윤아·유리·효연·써니, SM과 재계약	노컷뉴스
KCC글라스, 주거용 비강화 더블로이유리 출시	스트레이트뉴스
직장인 10명 중 7명, "승진? 이직해야 유리해"	이데일리
KCC글라스, `품질 우선주의` 유리 이맥스 클럽 확대	매일경제
삼광글라스, '환경의날' 맞이 유리용기 증정 이벤트	이데일리
'유리몸' 베일, 부상으로 토트넘 복귀전 바로 못 치른다...최대 한 달 소요	인터풋볼
유리 미니드라마, '이별유예, 일주일' 여주인공…어떤 역할?	데일리한국
쿨 유리, 으리으리한 LA 대저택서 '집콕' 생활 "계속 먹고 놀고"	스타뉴스
출연연 책임연구원, 남성이 여성 10배…“유리천장 존재해”	국민일보
랑세스, 재활용 유리섬유로 만든 플라스틱 출시	이데일리
KCC글라스, '유리 이맥스 클럽'에 대광유리·제일글라스 가입	아이뉴스24
이제야 깨졌다…美대형은행 유리천장 처음으로 깬 CEO	머니투데이
포스코ICT, 한국유리공업 스마트팩토리 구축	연합뉴스
'편스토랑' 소녀시대 유리·효연, 전혜빈 집에 깜짝 등장…요리실력 대공개	뉴스1
차량 안에 갇히면 옆유리 모서리 깨는 게 더 수월	MBN
유리의 '유리한 식탁' 수영 깜짝 등장…눈물 젖은 장어덮밥 사연 '폭소'	스포츠조선
유리의 '유리한 식탁' 수영 깜짝 등장…눈물 젖은 장어덮밥 사연 '폭소'	스포츠조선
'마이삭'에 창문 테이프 붙이려다…유리 깨져 60대 사망	머니투데이
공주는 유리구두가 아닌 군화를 신고 흙바닥을 굴렀다[청계천 옆 사진관]	동아일보언론사 선정
'유리한 식탁' 소녀시대 유리가 좌충우돌 개발한 분식 신메뉴	이데일리
구직자 10명 중 4명 "취업에 유리한 성별 있다!"	베리타스알파
"깨지지 않는 유리천장…과학기술 출연연 책임급 女 비율 고작 9.2%"	뉴스1
삼광글라스, '글라스락 베이비 세이프 유리식기&스낵뚜껑 흡착볼' 선봬	부산일보
서울 강남서 또 고가 외제차 파손…"앞유리 심하게 깨져"	연합뉴스언론사 선정
대형법인 유리했던 감정평가 시장, 중소형사에 기회열리나	매일경제
소녀시대 유리, 미니드라마 ‘이별유예, 일주일’로 안방극장 복귀(공식)	뉴스엔
KCC글라스, 주거용 비강화 더블로이유리 출시	스마트경제
[공식] 소녀시대 유리XAOA 찬미 '댕댕아 모하냥', 23일 첫 공개	스포츠조선
SM 측 "소녀시대 유리, 드라마 '보쌈' 출연 긍정 검토 중"[공식]	헤럴드POP
오비라거, 29CM 통해 유리잔 세트 등 '썸머 굿즈' 판매	조세일보
'덜덜 떨리는 창문 테이프 붙이려다…' 유리 깨지며 60대 숨져	SBS
교육차관 ‘수능 난도’ 조정 일축…“난도 낮추면 재학생 유리한가”	이데일리언론사 선정
"G80가 유리상자에 차곡차곡…" 제네시스 수지, 5000㎡ 가득 채운 '럭셔리'	더팩트언론사 선정
달라지는 개소세…국산차는 6월, 고가수입차는 7월 사는게 유리	아이뉴스24언론사 선정
[에따블라디] 폐유리병이 만든 '유리해변' 中관광객 싹쓸이에 사라질판	연합뉴스언론사 선정
[현장포토] "청순과 섹시사이"…유리, 설렘 주의보	디스패치
소녀시대 유리, 쿡방 ‘유리한 식탁’ 오늘(17일) 첫 공개	브릿지경제
[오늘의 신상품] 락앤락, 유리 밀폐용기 기준 높인 ‘탑클라스' 출시	이코노믹리뷰
혜림, 소녀시대 유리와 미모의 투샷 "걸크러쉬 유리언니"	일간스포츠
㈜뉴본, 쇼트유리빨대 한국 런칭 친환경 시장 선도	뉴스포인트
소녀시대 유리, 논현동 빌딩 128억에 매입 ... 재테크 비결은 은행 대출	Queen
소녀시대, 유리가 차린 식탁으로 "누구보다 먼저 떠올랐다"	뉴스컬처
소녀시대 유리, 드라마 '이별유예, 일주일' 주연 확정..가슴 절절 애틋 로맨스...	헤럴드POP
문세윤X김선호, 이름 불러도 심박수↑…유리 심장 주인은? [MK★TV컷]	MK스포츠
소녀시대 유리, 유튜브 실버버튼+예술문화인 상 들고 "경사났네"	헤럴드POP
'나의 판타집' 허영지의 유리 온실→양동근 '테마파크 하우스' 환성	스포츠조선
락앤락, 유리 밀폐용기 '탑클라스' 출시	미디어펜
'나의 판타집' 허영지의 유리 온실→양동근 '테마파크 하우스' 환성	스포츠조선
소녀시대 유리, 오늘도 예쁨주의보…남심 사로잡는 러블리 미모	헤럴드POP
KCC글라스, ‘품질 우선주의’ 유리 이맥스 클럽 확대	e대한경제
'편스토랑' 소녀시대 유리X효연, 절친 전혜빈 신혼집 방문→요리 실력 공개	텐아시아
"메시 FA 이적조항, 법적분쟁시 바르셀로나가 더 유리하다"[西매체]	스포츠조선
등록금 반환 예산 1천 억 확정‥비수도권 · 소규모 대학에 유리	EBS
옥주현·이진·성유리, 아름다운 핑클 미모…송혜교 "유리는 아직 애기" [★해...	엑스포츠뉴스
[금융세제 개편 Q&A] 양도세 부과이전 주식 팔면 유리?	헤럴드경제언론사 선정
소녀시대 유리, 요리하다 누워 기진맥진…수영 "정신 안차려?" 호통	스포츠조선
충주시, 우량기업 유치에 유리한 환경 조성	뉴스타운
여성직장인 10명 중 7명 "상대적으로 불리해...유리천장 여전"	뉴스핌
김두관 "지자체장 집무실에 침대 없애고 투명유리 설치하자"	한국경제언론사 선정
쿨 유리, ♥사재석+딸들과 단란하게..러블리한 LA 일상	헤럴드POP
‘유리한 식탁’ 유리 분식 메뉴 정식 출시…레시피 기대	매일경제
대림, 'e편한세상 남양뉴타운' 분양…가점경쟁 없어 3040 유리	아이뉴스24
'유리천장 깨졌다'…씨티그룹, 美 주요은행 사상 첫 여성 CEO	한국경제TV
[시그널] 역대급 열기 카카오게임즈 오늘 청약 마감···소액투자자는 KB證 ...	서울경제
쿨 유리, 궁전 같은 LA집 공개 ‘하늘 같은 층고+운동장 거실’ [SNS★컷]	뉴스엔
소녀시대, 데뷔 13주년 '유리한 식탁' 출연…예능감 발휘	뉴시스
코로나로 얇아진 유리지갑 "알바라도 하고파"	파이낸셜뉴스언론사 선정
[공식] 13년 의리 이어간다···SM "소녀시대 윤아·태연·유리·써니·효연...	서울경제
"가야인은 유리·수정 선호했다"…1700년전 유리 목걸이 보물 지정 예고	뉴스핌
강화유리 추락 현장 수습	연합뉴스
`편스토랑` 소녀시대 유리·효연, 전혜빈 집 방문 `요리실력 공개`	매일경제
[AsiaNet] AGC의 대형 곡선 커버 유리, 신형 2021 캐딜락 에스컬레이드에 사용	연합뉴스
[여의도 사사건건] 이재명 “유리한 내용 말 안한 게 죄? 공개적 판단 받고 싶...	KBS언론사 선정
애플, 맥북 키보드용 ‘투명 유리 키캡’ 특허 출원	IT조선
슈피겐코리아, 테슬라 모델3 전용 강화유리 출시	머니투데이
삼광글라스, ‘글라스락 베이비 세이프 유리식기&스낵뚜껑 흡착볼’ 출시	아시아타임즈
삼광글라스, ‘글라스락 베이비 세이프 유리식기&스낵뚜껑 흡착볼’ 출시	아시아타임즈
홈팀이 유리해! 심판 판정도 마찬가지! 코로나가 증명했어	조선일보언론사 선정
1700년 전 가야의 유리 세공 목걸이 3건 보물 지정 예고	위클리오늘
쿨 유리 "울고불고 결혼생활 쉽지 않아…주름도 많아져"	스포츠조선
소녀시대 태연ㆍ윤아ㆍ유리ㆍ효연ㆍ써니, SM과 재계약 [공식]	한국일보
삼광글라스, '유리로 전하는 사랑' 이벤트 실시	부산일보
삼성, 스마트폰 '초격차' 가속…유리처럼 '투명한 폰' 개발	아이뉴스24
쿨 유리, 으리으리한 '집콕' 생활 "LA 최고온도 45도…먹고 놀고" [★해시태그...	엑스포츠뉴스
구직자 10명 중 4명, "취업에 유리한 성별 있어"	파이낸셜투데이
삼성전자, '폴더블 유리' 자체 개발 본격화…코닝과 손잡았다	전자신문언론사 선정
테일즈런너, 치열한 유리구두 쟁탈전 맵 '앙리성 무도회장' 등장	청년일보
월가, 트럼프 부양책 '돌출 행동'에 "황당하다"…민주당에 유리	연합인포맥스
[팝업★]쿨 유리, 부러움 유발 LA 자택 '집콕' 육아 일상 "최고온도 45도..놀...	헤럴드POP
‘유리한 식탁’ 티아라 요민 지원사격…유리, 청어에 갈팡질팡	스포츠동아
삼광글라스㈜ ‘글라스락 베이비 세이프 유리식기&스낵뚜껑 흡착볼’ 출시	로이슈
셀트리온, JP모건 보고서 추가 반박…“시장경쟁력 유리한 위치 점유 중”	이코노믹리뷰
부산 해안가 아파트 유리 와장창…다가오는 '하이선'에 초긴장	연합뉴스
LG전자 승부수 ‘LG윙’ 출시, 공시지원금·선택약정 뭐가 유리하나?	브레이크뉴스
[론스타 ISDS 분쟁 8년 ②] ISDS 근거 조약 체결만 100개…“제소 움직임만으...	헤럴드경제
소녀시대 태연·윤아·유리·효연·써니 SM 재계약 확정[공식]	스타뉴스
남여주 물류단지 조성계획 변경…유리제품 원스톰 시스템 마련	뉴스1
삼광글라스, 세계 환경의 날 맞아 '유리로 전하는 사랑' 이벤트 실시	파이낸셜뉴스
‘유리한 식탁’ 원더걸스 혜림 등장…시가 위한 요리 수업	스포츠동아
고신용자엔 기업은행 카드론이 유리…저신용자는 대구은행	SBS CNBC
슈피겐코리아, 전기차 테슬라 모델3 내비게이션 전용 강화유리 제품 출시	에이빙뉴스
SM “소녀시대 태연-윤아-유리-효연-써니와 재계약”(공식)	뉴스엔
[정면승부]변상욱 "전광훈 '순교' 서사, 이단 규정·비위 전력 퉁 칠 유리점"	YTN
[DA:클립] ‘나의 판타집’ 허영지 유리온실 판타집, 집주인 공개	스포츠동아
실수로 9인조 소녀시대 언급한 장성규에 "현재는 8명"이라고 강조한 유리	인사이트
과학기술 출연연 女책임연구원 9%…“여전히 유리천장”	머니투데이
과학기술 출연연 女책임연구원 9%…“여전히 유리천장”	머니투데이
1,700년 전 가야 유리 목걸이 보물 지정 예고	M이코노미
락앤락 '탑클라스' 출시…유리 밀폐용기 신제품	컨슈머치
정보통신기술 업계 여성팀장 72% "유리천장 있다"	뉴스핌
10도 비튼 차량용 커브드 글라스…유리성형 기술 최강 입증	전자신문
쿨 유리, 남다른 패션 감각 '46세 맞아?'	스타뉴스
"지속적 R&D의 성과" KCC글라스, 주거용 비강화 '더블로이유리' 출시	Korea IT Times
"언제까지 이 고통"…태풍에 '유리 와장창’ 해운대 주민들 근본 대책 촉구	뉴스1
핀테크만 유리…마이데이터 '역차별' 논란	한국경제언론사 선정
경기도, 남여주 물류단지 유리제품 보관·가공 '원스톱 시스템' 마련	파이낸셜뉴스
'유리한 식탁' 유리, 이소라와 합동방송…"롤모델이었다"	엑스포츠뉴스
권유리, '유리한 식탁'으로 입증한 예능감+요리 실력! '완벽 멀티플레이어'	마켓뉴스
'댕댕아 모하냥' 소시 유리XAOA 찬미, 반려동물의 은밀한 사생활 공개	스포츠조선
구직자 44.8% "취업 유리한 성별 있어"	뉴스토마토
삼광글라스, 글라스락 베이비 세이프 유리식기 등 출시	아시아경제
고층빌딩서 강화유리 추락	연합뉴스
고속도로서 앞유리 뚫고 날아든 물체에 동승자 중상..."CCTV 조사중"	중부일보
소녀시대 유리, 만두보다 작은 얼굴 크기 ‘소멸 직전’ [SNS★컷]	뉴스엔
'여성임원 비중 39%' 씨티은행, 美 이어 韓서도 ‘금융권 유리천장’ 깰까	CEO스코어데일리
女장관 이끄는 부처도 유리천장 여전…공정위·중기부 女고위직 '0명'	이데일리언론사 선정
'여성임원 비중 39%' 씨티은행, 美 이어 韓서도 ‘금융권 유리천장’ 깰까	CEO스코어데일리
女장관 이끄는 부처도 유리천장 여전…공정위·중기부 女고위직 '0명'	이데일리언론사 선정
'LA 거주' 쿨 유리, 남다른 패션 소화력..애셋맘 맞나요	헤럴드POP
KCC글라스, 주거용 비강화 더블로이유리 출시	민주신문
둔촌주공조합 "HUG와 상한제 분양가 중 유리한 분양가 택할 것"	서울경제언론사 선정
한글라스, 밝고 화사한 실내 가능한 더블로이유리 출시	서울경제
"김민재, 라이벌 레스터에 뺏기나...현재까진 토트넘이 유리"[英매체]	스포츠조선
카드론 금리 따져보니…"신용도 좋으면 IBK, 나쁘면 DGB 유리"	한국경제
김경균 교수 개인전 '유리알유희'	내일신문
2030유리한 ‘지분적립형 주택’, 3기 신도시에도 가능할까[부동산360]	헤럴드경제언론사 선정
'유리한 식탁' VIP 손님 티파니의 키친 점령…"최수영 보고 있나?"	스포츠조선
삼광글라스, 환경의 날 맞아 '유리로 전하는 사랑' 이벤트	뉴데일리
틱톡 인수 뛰어든 트위터...MS보다 유리한 점은	머니투데이
부산 기장군 옛 한국유리 부지에 맞춤형 창업 지원 시설	연합뉴스
부산 해안가 아파트 유리 와장창…다가오는 '하이선'에 초긴장(종합)	연합뉴스
홍남기 "고용상황 꾸준히 개선"… 전문가 "유리한 수치로 자의적 해석"	조선비즈언론사 선정
화이트스톤, LG윙 용 강화유리 액정보호필름 할인 판매	ZDNet Korea
갤Z폴드2·플립 5G 오늘부터 사전 예약…"선택 약정 할인이 유리"	에너지경제
쿨 유리, LA '다둥이' 엄마 근황 "주름도 지고 감도 많이 잃고"	뉴스1
소시 유리를 긴장케 만든 요리사는 누구?	스포츠월드
